annee,cumul_periode,rss,region,nom_etablissement,nom_installation,no_permis_installation,nb_visites_total,nb_usagers_75ans_et_plus_total,nb_usagers_sante_mentale_total,dms_total,nb_usagers_pec_total,delai_pec_total,nb_visites_ambulatoire,nb_usagers_75ans_et_plus_amb,nb_usagers_sante_mentale_amb,dms_ambulatoire,nb_usagers_pec_ambulatoire,delai_pec_ambulatoire,nb_visites_sur_civiere,nb_usagers_sur_civiere_plus_24h,nb_usagers_sur_civiere_plus_48h,dms_sur_civiere,nb_usagers_pec_sur_civiere,delai_pec_sur_civiere,nb_usagers_75ans_et_plus_civ,nb_usagers_sante_mentale_civ
2020-2021,12,99,Total provincial,Total provincial,Total provincial,,2461296,382807,168323,8.1466066061,2131594,1.8334582657,1571735,123135,66924,3.7782696247,1248383,2.1660075629,889561,180118,45005,15.864872273,883211,1.3634132941,259672,101399
2021-2022,12,99,Total provincial,Total provincial,Total provincial,,3009560,448859,186877,8.5151212218,2477039,2.4210878021,2018561,157098,78072,4.4834670069,1494336,2.8737830899,990999,217455,58119,16.727177908,982703,1.732701926,291761,108805
2022-2023,12,99,Total provincial,Total provincial,Total provincial,,3286327,488064,188267,9.0681854911,2623672,2.7831699112,2255362,175625,77125,4.9011240157,1603094,3.3093113198,1030965,252194,77349,18.184142001,1020578,1.9567224126,312439,111142
2023-2024,12,99,Total provincial,Total provincial,Total provincial,,3265327,523864,190162,9.0649085811,2642611,2.8225566428,2193779,193446,76186,4.9376109406,1582356,3.3389318359,1071548,253105,69134,17.51472034,1060255,2.0519029935,330418,113976
2024-2025,12,99,Total provincial,Total provincial,Total provincial,,3478527,567790,199487,9.0279826614,2793422,2.9955987788,2339883,210990,78792,5.0751698963,1667458,3.5509628124,1138644,260907,65661,17.15090729,1125964,2.1731513466,356800,120695
2020-2021,12,08,Abitibi-Témiscamingue,Total régional,Total régional,,82084,9574,5304,5.1444246713,70815,2.0068605443,66013,5208,3989,3.7560773467,54796,2.2142666486,16071,1557,177,10.847179443,16019,1.297388986,4366,1315
2020-2021,12,01,Bas-Saint-Laurent,Total régional,Total régional,,92960,16104,4298,3.916289318,82041,1.2825207349,66697,7094,2601,2.5401139815,56032,1.4217234695,26263,352,2,7.4111972272,26009,0.9826319415,9010,1697
2020-2021,12,03,Capitale-Nationale,Total régional,Total régional,,267870,44163,17439,7.4504992627,233595,1.4290157347,167461,14560,5598,3.2194117851,133485,1.7604268873,100409,17408,3720,14.507059333,100110,0.9871176456,29603,11841
2020-2021,12,12,Chaudière-Appalaches,Total régional,Total régional,,133684,22723,7042,5.7158129391,117228,0.9029250904,91413,7958,3253,2.4341558884,74990,1.0730513587,42271,5447,441,12.812548667,42238,0.6008802763,14765,3789
2020-2021,12,09,Côte-Nord,Total régional,Total régional,,70773,8148,4019,6.1563324251,57290,1.9048874779,54745,4207,2429,3.1869814138,42252,1.9600682413,16028,2856,1423,16.29840387,15038,1.7498470726,3941,1590
2020-2021,12,05,Estrie,Total régional,Total régional,,168056,25915,10475,7.4598927804,147214,2.0603894519,103100,7775,3607,3.9561382396,82561,2.5752400817,64956,9769,1784,13.021151066,64653,1.4029322133,18140,6868
2020-2021,12,11,Gaspésie-Îles-de-la-Madeleine,Total régional,Total régional,,65509,10596,2782,4.5940584033,58939,1.2219425074,50759,5755,1860,2.5796933111,44504,1.308105445,14750,1690,443,11.526069096,14435,0.9562968287,4841,922
2020-2021,12,14,Lanaudière,Total régional,Total régional,,103746,16628,7314,9.5175733844,85535,2.3593830596,63017,4390,3611,4.7944346279,45070,2.9751644725,40729,10060,1547,16.825340209,40465,1.6735244587,12238,3703
2020-2021,12,15,Laurentides,Total régional,Total régional,,137377,21061,10502,10.732580059,115342,2.6545299703,85040,6591,3712,4.9964593394,63293,3.3039609172,52337,14679,4544,20.052940532,52049,1.864804271,14470,6790
2020-2021,12,13,Laval,Total régional,Total régional,,65505,11382,4778,8.399900313,53466,2.095535548,41136,3059,1437,4.2238381358,29148,2.6514924409,24369,4530,326,15.449286571,24318,1.4291554381,8323,3341
2020-2021,12,04,Mauricie et Centre-du-Québec,Total régional,Total régional,,172221,28680,10662,6.2191818458,145754,1.8918615727,107726,8385,3642,3.2742824904,81821,2.2912341337,64495,6211,414,11.138047308,63933,1.3807474014,20295,7020
2020-2021,12,06,Montréal,Total régional,Total régional,,588430,85558,49714,10.313035048,536966,1.7858854202,343662,20561,17543,4.5348410365,293899,2.2164251353,244768,64118,17949,18.425801873,243067,1.2653080004,64997,32171
2020-2021,12,16,Montérégie,Total régional,Total régional,,278961,48082,20044,10.157684751,229187,2.1829488947,175255,14473,8205,4.1490004279,125782,2.6052322934,103706,31043,9478,20.311889629,103405,1.6692827233,33609,11839
2020-2021,12,07,Outaouais,Total régional,Total régional,,110789,15085,7308,7.9263347946,88347,2.2261849236,76587,6151,3106,3.708349321,54647,2.2207867668,34202,7701,2559,17.371479917,33700,2.2349384273,8934,4202
2020-2021,12,02,Saguenay-Lac-Saint-Jean,Total régional,Total régional,,123331,19108,6642,5.2808152114,109875,1.6838253192,79124,6968,2331,2.8188106081,66103,1.8983314129,44207,2697,198,9.6874397783,43772,1.3598854417,12140,4311
2021-2022,12,08,Abitibi-Témiscamingue,Total régional,Total régional,,96528,10602,5767,5.7717312536,79041,2.640684592,78958,5770,4303,4.3361116986,61594,2.9236645615,17570,2256,378,12.223276434,17447,1.6416665234,4832,1464
2021-2022,12,01,Bas-Saint-Laurent,Total régional,Total régional,,115534,18294,4959,4.1141279503,101019,1.7090041257,86356,8721,3111,2.9812145074,72205,1.8988579854,29178,447,7,7.4671292964,28814,1.233249356,9573,1848
2021-2022,12,03,Capitale-Nationale,Total régional,Total régional,,324190,50529,18629,7.113268248,271998,1.7348101232,213658,18665,6378,3.577552571,161847,2.1686150655,110532,17909,3413,13.947795264,110151,1.0974121105,31864,12251
2021-2022,12,12,Chaudière-Appalaches,Total régional,Total régional,,183095,28472,8608,5.8508367772,159802,1.3220428127,134026,11386,4211,2.922059675,110778,1.561040517,49069,8160,897,13.850434892,49024,0.7819871729,17086,4397
2021-2022,12,09,Côte-Nord,Total régional,Total régional,,86728,9593,4973,6.861733504,70260,2.3863922336,67881,5089,3127,3.9014757852,51906,2.4679674155,18847,3620,1781,17.523656049,18354,2.1556936726,4504,1846
2021-2022,12,05,Estrie,Total régional,Total régional,,200997,30238,11281,8.062137583,168780,2.7631158214,127594,9628,4119,4.7233654665,95777,3.5327000567,73403,12552,2443,13.865814401,73003,1.7534522554,20610,7162
2021-2022,12,11,Gaspésie-Îles-de-la-Madeleine,Total régional,Total régional,,83637,13102,3377,4.934252298,74205,1.6117712531,66929,7708,2301,3.0222233055,57794,1.7209564622,16708,2303,591,12.593468748,16411,1.2272578183,5394,1076
2021-2022,12,14,Lanaudière,Total régional,Total régional,,125732,20410,8047,9.9582061514,95379,3.2132172497,81870,6072,4300,5.6976529016,51737,4.1104449105,43862,12715,1716,17.910681975,43642,2.149566008,14338,3747
2021-2022,12,15,Laurentides,Total régional,Total régional,,162529,25591,11289,12.105490651,125444,3.4929385002,105999,8696,4140,6.0146071216,69295,4.3394805501,56530,20111,7316,23.526462935,56149,2.4481980534,16895,7149
2021-2022,12,13,Laval,Total régional,Total régional,,79852,13075,5164,8.4738107756,62626,2.6918319778,52244,3775,1554,4.7978723979,35095,3.4138615583,27608,4924,380,15.429972925,27531,1.7714285008,9300,3610
2021-2022,12,04,Mauricie et Centre-du-Québec,Total régional,Total régional,,212350,34221,11595,7.0301411454,169519,2.7978821696,139112,10662,4079,4.3441169405,97348,3.4472124063,73238,9308,620,12.132112788,72171,1.9220317602,23559,7516
2021-2022,12,06,Montréal,Total régional,Total régional,,738126,101541,56143,10.48527765,632113,2.426443858,457158,26655,20893,5.399912492,353849,3.059311548,280968,74177,21870,18.759584207,278264,1.6216699769,74886,35250
2021-2022,12,16,Montérégie,Total régional,Total régional,,327738,55169,21257,10.876607333,242183,3.0816852591,216322,18426,9073,5.1261972006,131300,3.6883319603,111416,35529,12554,22.041433038,110883,2.3633360815,36743,12184
2021-2022,12,07,Outaouais,Total régional,Total régional,,123623,16134,8113,8.1880549354,96151,2.3017979012,90037,7319,3637,3.8344374998,63067,2.3165706268,33586,8665,3623,19.859187343,33084,2.2736371139,8815,4476
2021-2022,12,02,Saguenay-Lac-Saint-Jean,Total régional,Total régional,,148901,21888,7675,5.9322796448,128519,2.2568917285,100417,8526,2846,3.4137170582,80744,2.5477588324,48484,4779,530,11.148567477,47775,1.7653004477,13362,4829
2022-2023,12,08,Abitibi-Témiscamingue,Total régional,Total régional,,104840,11359,5582,6.1836365732,87673,2.9463138404,86171,6064,4105,4.7713553928,69169,3.2332258631,18669,2480,469,12.702340392,18504,1.8738204502,5295,1477
2022-2023,12,01,Bas-Saint-Laurent,Total régional,Total régional,,130299,20443,4773,4.4240147938,112243,1.9531595239,97944,9485,2878,3.1825121526,80433,2.1264469013,32355,1059,47,8.1822510689,31810,1.514994682,10958,1895
2022-2023,12,03,Capitale-Nationale,Total régional,Total régional,,354454,55353,18839,7.5039786678,290672,1.9228575001,236842,20738,6813,3.7281765809,173716,2.3819463473,117612,21482,5392,15.107526927,116956,1.2409679162,34615,12026
2022-2023,12,12,Chaudière-Appalaches,Total régional,Total régional,,222245,33485,9376,6.1401810689,191009,1.7181019597,172071,15220,4965,3.3419801387,140896,2.0134813681,50174,11017,2115,15.73657028,50113,0.8876232991,18265,4411
2022-2023,12,09,Côte-Nord,Total régional,Total régional,,94705,10273,4647,6.6021815433,75532,2.8300822683,75236,5671,3031,4.3945682807,56503,2.9811489065,19469,3387,1351,15.133281827,19029,2.3815185886,4602,1616
2022-2023,12,05,Estrie,Total régional,Total régional,,219601,32745,11458,8.7837554335,178383,3.2823093335,144237,10768,3980,5.3529678142,103428,4.2469782092,75364,15656,3653,15.349841547,74955,1.9511936977,21977,7478
2022-2023,12,11,Gaspésie-Îles-de-la-Madeleine,Total régional,Total régional,,92665,14485,3649,5.5091564656,81388,1.9617407699,75222,8703,2434,3.4959728315,64269,2.1084169532,17443,2950,950,14.190902686,17119,1.4110817578,5782,1215
2022-2023,12,14,Lanaudière,Total régional,Total régional,,132699,21875,8060,10.952831088,94978,3.8104022393,89077,6712,4291,6.2412315905,51560,4.8365926914,43622,14726,3564,20.574011877,43418,2.5917744881,15163,3769
2022-2023,12,15,Laurentides,Total régional,Total régional,,175620,27942,11432,12.398869629,130576,3.9891159129,116184,9525,3887,6.4915338601,71605,4.9261800852,59436,21766,7857,23.94638122,58971,2.8512942708,18417,7545
2022-2023,12,13,Laval,Total régional,Total régional,,85630,14605,5371,9.3653545811,64404,3.099714338,56417,4075,1539,5.4632937176,35300,3.99373209,29213,6733,565,16.901128645,29104,2.015367628,10530,3832
2022-2023,12,04,Mauricie et Centre-du-Québec,Total régional,Total régional,,224651,36088,11267,7.8259260908,173433,3.1570039295,149575,11529,3556,4.7547691979,99502,3.945534791,75076,12851,1839,13.944636361,73931,2.0957387256,24559,7711
2022-2023,12,06,Montréal,Total régional,Total régional,,792716,108351,56941,11.184104612,647976,2.7478322838,499408,28715,20534,5.8478008445,358425,3.5843030519,293308,83496,27592,20.270092011,289551,1.7123945369,79636,36407
2022-2023,12,16,Montérégie,Total régional,Total régional,,344594,58808,20917,11.767366595,246150,3.5572564346,233244,20547,8535,5.742475281,135356,4.1683389584,111350,38095,15751,24.387660709,110794,2.8107025952,38261,12382
2022-2023,12,07,Outaouais,Total régional,Total régional,,144368,18133,7900,9.1378268691,107131,2.9237506806,107549,8263,3538,4.4095399436,71070,2.9700348014,36819,10592,5346,22.949243001,36061,2.8325326761,9870,4362
2022-2023,12,02,Saguenay-Lac-Saint-Jean,Total régional,Total régional,,167240,24119,8055,6.3154135441,142124,2.6683473156,116185,9610,3039,3.8175676483,91862,2.9838966542,51055,5904,858,11.999719203,50262,2.0916294506,14509,5016
2023-2024,12,08,Abitibi-Témiscamingue,Total régional,Total régional,,103099,12141,5429,6.2595599672,87595,2.8622611609,83158,6494,3891,4.8381108185,67852,3.1530417878,19941,2372,445,12.187290187,19743,1.8629172365,5647,1538
2023-2024,12,01,Bas-Saint-Laurent,Total régional,Total régional,,124612,21541,5119,4.7609136315,108687,1.9858063087,92579,10390,3032,3.335156341,77190,2.1758842575,32033,1567,206,8.8815137688,31497,1.5199804567,11151,2087
2023-2024,12,03,Capitale-Nationale,Total régional,Total régional,,354500,59494,19273,7.4899836201,293617,1.9928467102,233938,22133,6990,3.7909208518,173799,2.4629779947,120562,21404,4446,14.667629528,119818,1.3109095461,37361,12283
2023-2024,12,12,Chaudière-Appalaches,Total régional,Total régional,,220688,34842,9301,6.0125343345,190596,1.8776478855,172179,16735,4939,3.4502228269,142153,2.2065228428,48509,9168,1847,15.10726383,48443,0.9125845782,18107,4362
2023-2024,12,09,Côte-Nord,Total régional,Total régional,,92525,10647,4956,6.4528264043,74176,2.7762591487,72958,6086,3155,4.0363727076,55055,2.9209584405,19567,3580,1372,15.462875405,19121,2.3596271987,4561,1801
2023-2024,12,05,Estrie,Total régional,Total régional,,217525,34987,11438,8.8405461377,179475,3.357869968,142056,12408,4131,5.4576660789,104397,4.3255942221,75469,15418,3292,15.208172708,75078,2.0122359746,22579,7307
2023-2024,12,11,Gaspésie-Îles-de-la-Madeleine,Total régional,Total régional,,91330,15217,3587,5.3830185074,81416,1.8324463523,73597,9212,2382,3.3551212421,63932,1.9624147097,17733,3019,775,13.799369662,17484,1.3572040151,6005,1205
2023-2024,12,14,Lanaudière,Total régional,Total régional,,134274,24250,8460,10.765661556,97973,3.8931594646,88195,7792,4504,6.1896471928,52146,4.862619371,46079,14766,2769,19.524132589,45827,2.7900225304,16458,3956
2023-2024,12,15,Laurentides,Total régional,Total régional,,174791,30901,11878,12.152784704,133173,3.9220902281,113259,10831,3777,6.4996517152,72162,4.897883412,61532,21153,6893,22.558235349,61011,2.7679510116,20070,8101
2023-2024,12,13,Laval,Total régional,Total régional,,83289,16125,5246,10.02408507,65184,2.9930271104,52847,4797,1295,5.472088219,34815,3.8171035872,30442,7504,981,17.92630495,30369,2.0483064236,11328,3951
2023-2024,12,04,Mauricie et Centre-du-Québec,Total régional,Total régional,,222648,38826,11230,7.4585893054,175684,3.0134008283,144774,12578,3508,4.6210280621,99081,3.7621886386,77874,10906,976,12.73384281,76603,2.0448924796,26248,7722
2023-2024,12,06,Montréal,Total régional,Total régional,,792711,114496,56891,11.216681282,653094,2.6695932451,487895,31685,19890,5.6856382606,351845,3.4627603995,304816,86554,26918,20.069786877,301249,1.7432104274,82811,37001
2023-2024,12,16,Montérégie,Total régional,Total régional,,346486,64944,21092,11.520945351,254580,3.8060315203,220691,22642,7986,6.0848752466,129849,4.5026848344,125795,39049,12858,21.057824777,124731,3.0807929175,42302,13106
2023-2024,12,07,Outaouais,Total régional,Total régional,,143222,19606,7881,9.7240561487,106906,3.4873371181,104468,8821,3343,5.1166054704,69183,3.4287859453,38754,11570,4937,22.144223292,37723,3.5947184447,10785,4538
2023-2024,12,02,Saguenay-Lac-Saint-Jean,Total régional,Total régional,,163627,25847,8381,6.2706268967,140455,2.691889943,111185,10842,3363,3.8828047973,88897,3.0260054708,52442,5075,419,11.333172187,51558,2.1158034371,15005,5018
2024-2025,12,08,Abitibi-Témiscamingue,Total régional,Total régional,,112211,13632,5794,6.4405327959,93941,3.2300989333,90985,7520,4243,5.1075477307,72954,3.563638122,21226,2715,400,12.154357641,20987,2.0706660472,6112,1551
2024-2025,12,01,Bas-Saint-Laurent,Total régional,Total régional,,136214,23414,5264,4.8126209086,118229,2.0725915948,104649,11803,3181,3.3947326433,87116,2.2818821871,31565,2025,214,9.513415747,31113,1.4865806272,11611,2083
2024-2025,12,03,Capitale-Nationale,Total régional,Total régional,,380560,65278,20419,7.3162463373,313640,2.1075536036,252967,24449,7610,3.9265230698,187014,2.5836848712,127593,21789,2868,14.036741394,126626,1.4043551066,40829,12809
2024-2025,12,12,Chaudière-Appalaches,Total régional,Total régional,,229704,37340,9741,6.4370645507,199594,1.9936722366,178502,18319,5003,3.6239208431,148469,2.3471890391,51202,10553,2856,16.24433337,51125,0.9670456126,19021,4738
2024-2025,12,09,Côte-Nord,Total régional,Total régional,,96035,11327,5265,6.8017701851,77809,3.2605567943,75731,6395,3144,4.8133632785,57970,3.4778245309,20304,3380,1067,14.218241986,19839,2.6256956276,4932,2121
2024-2025,12,05,Estrie,Total régional,Total régional,,223948,36711,11130,8.6965110638,181867,3.6845331158,147927,13349,4068,5.8430282598,106397,4.738019232,76021,13474,1907,14.249018276,75470,2.1993368483,23362,7062
2024-2025,12,11,Gaspésie-Îles-de-la-Madeleine,Total régional,Total régional,,96905,16151,3729,5.0734230575,85281,2.025446387,77657,9976,2378,3.5291714598,66344,2.1854209708,19248,2245,342,11.303781865,18937,1.4649904655,6175,1351
2024-2025,12,14,Lanaudière,Total régional,Total régional,,147288,27177,9095,10.117993879,108764,3.4208263406,97063,8598,4688,5.7219029794,58762,4.2827136679,50225,15315,2134,18.613718539,50002,2.4079423934,18579,4407
2024-2025,12,15,Laurentides,Total régional,Total régional,,192471,34648,12195,11.985461686,146828,3.882342376,124698,12279,3924,6.3208812469,79568,4.8331567583,67773,22452,7543,22.40792862,67260,2.7575371609,22369,8271
2024-2025,12,13,Laval,Total régional,Total régional,,85984,16703,5655,11.002881253,66532,3.7259846139,53649,4988,1232,6.4194124722,34342,4.7515791726,32335,8992,1086,18.607598019,32190,2.6318259207,11715,4423
2024-2025,12,04,Mauricie et Centre-du-Québec,Total régional,Total régional,,235692,42234,11822,7.4069611859,185383,3.1563094527,151969,14293,3584,4.8289890171,103163,3.9638948261,83723,10141,690,12.086342629,82220,2.1430167032,27941,8238
2024-2025,12,06,Montréal,Total régional,Total régional,,853098,124762,59851,11.025983269,689889,2.7641749981,527072,33947,20865,5.6875260311,367367,3.615027719,326026,89051,27110,19.65643401,322522,1.7950156492,90815,38986
2024-2025,12,16,Montérégie,Total régional,Total régional,,355011,68102,22612,11.596987514,258263,4.0704506818,219953,23235,8101,6.1205128116,124572,4.9181123522,135058,41082,12865,20.515874513,133691,3.2806076138,44867,14511
2024-2025,12,07,Outaouais,Total régional,Total régional,,157551,22071,8501,9.7397878853,117486,4.2292213824,116027,9865,3462,5.5765176688,77393,4.0846400371,41524,12445,4201,21.372861611,40093,4.508312098,12206,5039
2024-2025,12,02,Saguenay-Lac-Saint-Jean,Total régional,Total régional,,175855,28240,8414,6.3903222794,149916,2.8936793104,121034,11974,3309,4.1263401331,96027,3.2779960439,54821,5248,378,11.388750165,53889,2.2088496982,16266,5105
2020-2021,12,01,Bas-Saint-Laurent,CISSS DU BAS-SAINT-LAURENT,Total établissement,,92960,16104,4298,3.916289318,82041,1.2825207349,66697,7094,2601,2.5401139815,56032,1.4217234695,26263,352,2,7.4111972272,26009,0.9826319415,9010,1697
2020-2021,12,02,Saguenay-Lac-Saint-Jean,CIUSSS DU SAGUENAY - LAC-SAINT-JEAN,Total établissement,,123331,19108,6642,5.2808152114,109875,1.6838253192,79124,6968,2331,2.8188106081,66103,1.8983314129,44207,2697,198,9.6874397783,43772,1.3598854417,12140,4311
2020-2021,12,03,Capitale-Nationale,CHU DE QUÉBEC - UNIVERSITÉ LAVAL,Total établissement,,176402,28954,15095,9.0457719993,156185,1.4720485767,99591,7592,4163,3.7052359986,79547,1.927379603,76811,15988,3628,15.970162007,76638,0.999434245,21362,10932
2020-2021,12,03,Capitale-Nationale,CIUSSS DE LA CAPITALE-NATIONALE,Total établissement,,71135,9001,1805,3.4110221371,57856,1.3154286072,58077,5134,1123,2.3087037037,44914,1.450920302,13058,634,91,8.313713794,12942,0.8452173586,3867,682
2020-2021,12,03,Capitale-Nationale,INSTITUT UNIVERSITAIRE DE CARDIOLOGIE ET DE PNEUMOLOGIE DE QUÉBEC - UNIVERSITÉ LAVAL,Total établissement,,20333,6208,539,7.7425812991,19554,1.4213759901,9793,1834,312,3.6796868795,9024,1.8291980644,10540,786,1,11.51752675,10530,1.0718806057,4374,227
2020-2021,12,04,Mauricie et Centre-du-Québec,CIUSSS DE LA MAURICIE-ET-DU-CENTRE-DU-QUÉBEC,Total établissement,,172221,28680,10662,6.2191818458,145754,1.8918615727,107726,8385,3642,3.2742824904,81821,2.2912341337,64495,6211,414,11.138047308,63933,1.3807474014,20295,7020
2020-2021,12,05,Estrie,CIUSSS DE L'ESTRIE - CENTRE HOSPITALIER UNIVERSITAIRE DE SHERBROOKE,Total établissement,,168056,25915,10475,7.4598927804,147214,2.0603894519,103100,7775,3607,3.9561382396,82561,2.5752400817,64956,9769,1784,13.021151066,64653,1.4029322133,18140,6868
2020-2021,12,06,Montréal,CENTRE HOSPITALIER DE L'UNIVERSITÉ DE MONTRÉAL,Total établissement,,47576,6912,3719,12.802673529,41917,2.1010792823,27917,1912,1561,5.7383659598,22345,2.8042296934,19659,7422,1781,22.834428676,19572,1.2983051184,5000,2158
2020-2021,12,06,Montréal,CENTRE HOSPITALIER UNIVERSITAIRE SAINTE-JUSTINE,Total établissement,,44450,0,1516,4.1869820147,42868,1.0237273854,30425,0,744,3.3673456313,28959,1.1467989418,14025,48,0,5.9650523866,13909,0.7674883169,0,772
2020-2021,12,06,Montréal,CENTRE UNIVERSITAIRE DE SANTÉ MCGILL,Total établissement,,106964,11427,6276,9.8839022864,99350,1.6281384248,60295,2449,1711,4.6568810616,53041,1.8985605161,46669,9712,3097,16.63706273,46309,1.3184047197,8978,4565
2020-2021,12,06,Montréal,CIUSSS DE L'EST-DE-L'ÎLE-DE-MONTRÉAL,Total établissement,,79963,16275,9348,14.23486219,68984,2.5427457776,43717,3517,3263,5.0734865537,32928,3.4508102611,36246,14324,5259,25.284574122,36056,1.7134594643,12758,6085
2020-2021,12,06,Montréal,CIUSSS DE L'OUEST-DE-L'ÎLE-DE-MONTRÉAL,Total établissement,,81193,13440,9417,10.445959357,76254,1.9661788416,51081,3650,3118,4.9063052798,46218,2.2994090626,30112,8798,1993,19.843245153,30036,1.4534196742,9790,6299
2020-2021,12,06,Montréal,CIUSSS DU CENTRE-OUEST-DE-L'ÎLE-DE-MONTRÉAL,Total établissement,,58662,10698,3231,8.4965412779,55517,1.1487803185,22783,1193,382,3.2765587036,19929,1.2539578141,35879,4042,720,11.811206207,35588,1.0898817485,9505,2849
2020-2021,12,06,Montréal,CIUSSS DU CENTRE-SUD-DE-L'ÎLE-DE-MONTRÉAL,Total établissement,,57278,8035,6818,11.620514809,51490,1.6880976349,33299,1930,2429,4.2045571105,28025,2.1481792546,23979,8556,2696,21.918858168,23465,1.1386074413,6105,4389
2020-2021,12,06,Montréal,CIUSSS DU NORD-DE-L'ÎLE-DE-MONTRÉAL,Total établissement,,97533,14915,8891,9.5943226253,86125,1.996085641,65029,4276,3913,4.5950981229,53684,2.570980289,32504,9656,2229,19.596001501,32441,1.0447387565,10639,4978
2020-2021,12,06,Montréal,INSTITUT DE CARDIOLOGIE DE MONTRÉAL,Total établissement,,14811,3856,498,8.7690269995,14461,1.1963540634,9116,1634,422,3.1952426137,8770,1.3360543203,5695,1560,174,17.690996878,5691,0.9810718191,2222,76
2020-2021,12,07,Outaouais,CISSS DE L'OUTAOUAIS,Total établissement,,110789,15085,7308,7.9263347946,88347,2.2261849236,76587,6151,3106,3.708349321,54647,2.2207867668,34202,7701,2559,17.371479917,33700,2.2349384273,8934,4202
2020-2021,12,08,Abitibi-Témiscamingue,CISSS DE L'ABITIBI-TÉMISCAMINGUE,Total établissement,,82084,9574,5304,5.1444246713,70815,2.0068605443,66013,5208,3989,3.7560773467,54796,2.2142666486,16071,1557,177,10.847179443,16019,1.297388986,4366,1315
2020-2021,12,09,Côte-Nord,CISSS DE LA CÔTE-NORD,Total établissement,,70773,8148,4019,6.1563324251,57290,1.9048874779,54745,4207,2429,3.1869814138,42252,1.9600682413,16028,2856,1423,16.29840387,15038,1.7498470726,3941,1590
2020-2021,12,11,Gaspésie-Îles-de-la-Madeleine,CISSS DE LA GASPÉSIE,Total établissement,,55562,9463,2492,4.8039402179,50423,1.2990983612,42722,5091,1709,2.7238424452,37881,1.3962510083,12840,1557,434,11.724963352,12542,1.0056651429,4372,783
2020-2021,12,11,Gaspésie-Îles-de-la-Madeleine,CISSS DES ÎLES,Total établissement,,9947,1133,290,3.4216995632,8516,0.7651048353,8037,664,151,1.813444797,6623,0.8039468938,1910,133,9,10.188999855,1893,0.6292089276,469,139
2020-2021,12,12,Chaudière-Appalaches,CISSS DE CHAUDIÈRE-APPALACHES,Total établissement,,133684,22723,7042,5.7158129391,117228,0.9029250904,91413,7958,3253,2.4341558884,74990,1.0730513587,42271,5447,441,12.812548667,42238,0.6008802763,14765,3789
2020-2021,12,13,Laval,CISSS DE LAVAL,Total établissement,,65505,11382,4778,8.399900313,53466,2.095535548,41136,3059,1437,4.2238381358,29148,2.6514924409,24369,4530,326,15.449286571,24318,1.4291554381,8323,3341
2020-2021,12,14,Lanaudière,CISSS DE LANAUDIÈRE,Total établissement,,103746,16628,7314,9.5175733844,85535,2.3593830596,63017,4390,3611,4.7944346279,45070,2.9751644725,40729,10060,1547,16.825340209,40465,1.6735244587,12238,3703
2020-2021,12,15,Laurentides,CISSS DES LAURENTIDES,Total établissement,,137377,21061,10502,10.732580059,115342,2.6545299703,85040,6591,3712,4.9964593394,63293,3.3039609172,52337,14679,4544,20.052940532,52049,1.864804271,14470,6790
2020-2021,12,16,Montérégie,CISSS DE LA MONTÉRÉGIE-CENTRE,Total établissement,,100654,17106,8655,9.6856294528,78018,2.2647842378,64823,5109,3329,4.0119292835,42250,2.6864876857,35831,10878,2645,19.950100611,35768,1.7666582405,11997,5326
2020-2021,12,16,Montérégie,CISSS DE LA MONTÉRÉGIE-EST,Total établissement,,103819,18211,6647,9.5081482623,86418,2.1264676405,62079,5819,2467,3.9462090643,44855,2.538404086,41740,10862,2922,17.780300238,41563,1.6819037432,12392,4180
2020-2021,12,16,Montérégie,CISSS DE LA MONTÉRÉGIE-OUEST,Total établissement,,74488,12765,4742,11.700865971,64751,2.1597271256,48353,3545,2409,4.5931186391,38677,2.5939733778,26135,9303,3911,24.851082414,26074,1.5155857474,9220,2333
2021-2022,12,01,Bas-Saint-Laurent,CISSS DU BAS-SAINT-LAURENT,Total établissement,,115534,18294,4959,4.1141279503,101019,1.7090041257,86356,8721,3111,2.9812145074,72205,1.8988579854,29178,447,7,7.4671292964,28814,1.233249356,9573,1848
2021-2022,12,02,Saguenay-Lac-Saint-Jean,CIUSSS DU SAGUENAY - LAC-SAINT-JEAN,Total établissement,,148901,21888,7675,5.9322796448,128519,2.2568917285,100417,8526,2846,3.4137170582,80744,2.5477588324,48484,4779,530,11.148567477,47775,1.7653004477,13362,4829
2021-2022,12,03,Capitale-Nationale,CHU DE QUÉBEC - UNIVERSITÉ LAVAL,Total établissement,,206372,32251,16015,8.5936960588,175228,1.7236967456,122705,9647,4759,3.9957534443,91782,2.3002964452,83667,16322,3376,15.336982522,83446,1.0894965007,22604,11256
2021-2022,12,03,Capitale-Nationale,CIUSSS DE LA CAPITALE-NATIONALE,Total établissement,,93585,10925,2047,3.7070813224,73670,1.7716503854,78565,6613,1291,2.8820456275,58790,1.9688531118,15020,587,37,8.0225892699,14880,0.9925140756,4312,756
2021-2022,12,03,Capitale-Nationale,INSTITUT UNIVERSITAIRE DE CARDIOLOGIE ET DE PNEUMOLOGIE DE QUÉBEC - UNIVERSITÉ LAVAL,Total établissement,,24233,7353,567,7.6600084481,23100,1.7016219336,12388,2405,328,3.8461322337,11275,2.138284676,11845,1000,0,11.648720862,11825,1.2852690862,4948,239
2021-2022,12,04,Mauricie et Centre-du-Québec,CIUSSS DE LA MAURICIE-ET-DU-CENTRE-DU-QUÉBEC,Total établissement,,212350,34221,11595,7.0301411454,169519,2.7978821696,139112,10662,4079,4.3441169405,97348,3.4472124063,73238,9308,620,12.132112788,72171,1.9220317602,23559,7516
2021-2022,12,05,Estrie,CIUSSS DE L'ESTRIE - CENTRE HOSPITALIER UNIVERSITAIRE DE SHERBROOKE,Total établissement,,200997,30238,11281,8.062137583,168780,2.7631158214,127594,9628,4119,4.7233654665,95777,3.5327000567,73403,12552,2443,13.865814401,73003,1.7534522554,20610,7162
2021-2022,12,06,Montréal,CENTRE HOSPITALIER DE L'UNIVERSITÉ DE MONTRÉAL,Total établissement,,57226,8291,4622,13.468434705,46488,2.8925793275,34799,2453,1789,6.9379562312,24225,4.1485295838,22427,8655,2369,23.601493983,22263,1.5259443297,5838,2833
2021-2022,12,06,Montréal,CENTRE HOSPITALIER UNIVERSITAIRE SAINTE-JUSTINE,Total établissement,,71758,1,2075,5.1553234212,63157,1.8152230816,49464,1,1036,4.3809400776,41482,2.1041908271,22294,291,0,6.8734582424,21675,1.2621914776,0,1039
2021-2022,12,06,Montréal,CENTRE UNIVERSITAIRE DE SANTÉ MCGILL,Total établissement,,147837,13248,7542,10.189728194,128623,2.3786971507,95916,3496,2104,5.784785081,77133,2.8728395074,51921,11681,4542,18.327177849,51490,1.6384624954,9752,5438
2021-2022,12,06,Montréal,CIUSSS DE L'EST-DE-L'ÎLE-DE-MONTRÉAL,Total établissement,,92301,18014,10313,13.142886886,72605,3.2112440374,51834,3962,3561,5.5298283355,32547,4.3560107434,40467,14533,4832,22.894419664,40058,2.2811246609,14052,6752
2021-2022,12,06,Montréal,CIUSSS DE L'OUEST-DE-L'ÎLE-DE-MONTRÉAL,Total établissement,,92621,15819,10380,11.357792197,81295,2.6066990009,60989,4834,4097,5.9664553763,49772,3.1844309998,31632,9820,3251,21.752716368,31523,1.6945118027,10985,6283
2021-2022,12,06,Montréal,CIUSSS DU CENTRE-OUEST-DE-L'ÎLE-DE-MONTRÉAL,Total établissement,,76479,13377,4007,9.2543281634,69587,1.8541106856,30736,1760,524,3.9772516484,24641,2.0955993286,45743,6322,1178,12.800143343,44946,1.7217179999,11617,3483
2021-2022,12,06,Montréal,CIUSSS DU CENTRE-SUD-DE-L'ÎLE-DE-MONTRÉAL,Total établissement,,65710,9709,7158,11.490771868,57711,2.0683645665,42577,2721,3076,4.8016941528,34663,2.631670938,23133,8758,2501,23.802225717,23048,1.2211809171,6988,4082
2021-2022,12,06,Montréal,CIUSSS DU NORD-DE-L'ÎLE-DE-MONTRÉAL,Total établissement,,117578,18750,9545,10.274434694,96478,2.7127982603,80580,5721,4289,5.48422286,59567,3.5871916451,36998,12143,2982,20.707303218,36911,1.3017015479,13029,5256
2021-2022,12,06,Montréal,INSTITUT DE CARDIOLOGIE DE MONTRÉAL,Total établissement,,16616,4332,501,9.4136568334,16169,1.4557835295,10263,1707,417,3.5565141501,9819,1.6652744962,6353,1974,215,18.875620529,6350,1.1318478128,2625,84
2021-2022,12,07,Outaouais,CISSS DE L'OUTAOUAIS,Total établissement,,123623,16134,8113,8.1880549354,96151,2.3017979012,90037,7319,3637,3.8344374998,63067,2.3165706268,33586,8665,3623,19.859187343,33084,2.2736371139,8815,4476
2021-2022,12,08,Abitibi-Témiscamingue,CISSS DE L'ABITIBI-TÉMISCAMINGUE,Total établissement,,96528,10602,5767,5.7717312536,79041,2.640684592,78958,5770,4303,4.3361116986,61594,2.9236645615,17570,2256,378,12.223276434,17447,1.6416665234,4832,1464
2021-2022,12,09,Côte-Nord,CISSS DE LA CÔTE-NORD,Total établissement,,86728,9593,4973,6.861733504,70260,2.3863922336,67881,5089,3127,3.9014757852,51906,2.4679674155,18847,3620,1781,17.523656049,18354,2.1556936726,4504,1846
2021-2022,12,11,Gaspésie-Îles-de-la-Madeleine,CISSS DE LA GASPÉSIE,Total établissement,,68984,11317,2954,5.2462688812,61304,1.7083751287,54645,6505,2056,3.170782856,47249,1.8316165186,14339,2178,589,13.155811656,14055,1.2940718605,4812,898
2021-2022,12,11,Gaspésie-Îles-de-la-Madeleine,CISSS DES ÎLES,Total établissement,,14653,1785,423,3.4653277107,12901,1.1527212576,12284,1203,245,2.3613606679,10545,1.2251217533,2369,125,2,9.1897393415,2356,0.8286706518,582,178
2021-2022,12,12,Chaudière-Appalaches,CISSS DE CHAUDIÈRE-APPALACHES,Total établissement,,183095,28472,8608,5.8508367772,159802,1.3220428127,134026,11386,4211,2.922059675,110778,1.561040517,49069,8160,897,13.850434892,49024,0.7819871729,17086,4397
2021-2022,12,13,Laval,CISSS DE LAVAL,Total établissement,,79852,13075,5164,8.4738107756,62626,2.6918319778,52244,3775,1554,4.7978723979,35095,3.4138615583,27608,4924,380,15.429972925,27531,1.7714285008,9300,3610
2021-2022,12,14,Lanaudière,CISSS DE LANAUDIÈRE,Total établissement,,125732,20410,8047,9.9582061514,95379,3.2132172497,81870,6072,4300,5.6976529016,51737,4.1104449105,43862,12715,1716,17.910681975,43642,2.149566008,14338,3747
2021-2022,12,15,Laurentides,CISSS DES LAURENTIDES,Total établissement,,162529,25591,11289,12.105490651,125444,3.4929385002,105999,8696,4140,6.0146071216,69295,4.3394805501,56530,20111,7316,23.526462935,56149,2.4481980534,16895,7149
2021-2022,12,16,Montérégie,CISSS DE LA MONTÉRÉGIE-CENTRE,Total établissement,,121975,19179,9193,9.5889710596,81020,3.500999544,85587,6915,3871,5.122083494,44712,4.1376878318,36388,11333,2702,20.095388177,36308,2.7169407492,12264,5322
2021-2022,12,16,Montérégie,CISSS DE LA MONTÉRÉGIE-EST,Total établissement,,121862,21445,7141,10.595268464,93490,3.1638678231,74858,7200,2698,4.8177100495,46842,3.823829576,47004,13521,5026,19.796537883,46648,2.5011614169,14245,4443
2021-2022,12,16,Montérégie,CISSS DE LA MONTÉRÉGIE-OUEST,Total établissement,,83901,14545,4923,13.157199361,67673,2.4661356121,55877,4311,2504,5.5457761144,39746,3.0231435379,28024,10675,4826,28.333601615,27927,1.6733960763,10234,2419
2022-2023,12,01,Bas-Saint-Laurent,CISSS DU BAS-SAINT-LAURENT,Total établissement,,130299,20443,4773,4.4240147938,112243,1.9531595239,97944,9485,2878,3.1825121526,80433,2.1264469013,32355,1059,47,8.1822510689,31810,1.514994682,10958,1895
2022-2023,12,02,Saguenay-Lac-Saint-Jean,CIUSSS DU SAGUENAY - LAC-SAINT-JEAN,Total établissement,,167240,24119,8055,6.3154135441,142124,2.6683473156,116185,9610,3039,3.8175676483,91862,2.9838966542,51055,5904,858,11.999719203,50262,2.0916294506,14509,5016
2022-2023,12,03,Capitale-Nationale,CHU DE QUÉBEC - UNIVERSITÉ LAVAL,Total établissement,,211013,34114,16042,9.3724316222,178440,1.8641260679,124303,10100,5096,4.1934662232,92064,2.4575440273,86710,18959,5197,16.796730273,86376,1.2316305712,24014,10946
2022-2023,12,03,Capitale-Nationale,CIUSSS DE LA CAPITALE-NATIONALE,Total établissement,,117846,13094,2215,3.9884619357,88028,2.035429595,99466,7988,1403,3.1105837869,69936,2.2693687006,18380,1063,194,8.7392251542,18092,1.1311202158,5106,812
2022-2023,12,03,Capitale-Nationale,INSTITUT UNIVERSITAIRE DE CARDIOLOGIE ET DE PNEUMOLOGIE DE QUÉBEC - UNIVERSITÉ LAVAL,Total établissement,,25595,8145,582,8.2862299494,24204,1.9464296535,13073,2650,314,4.0029862227,11716,2.4599085771,12522,1460,1,12.757947346,12488,1.4646936615,5495,268
2022-2023,12,04,Mauricie et Centre-du-Québec,CIUSSS DE LA MAURICIE-ET-DU-CENTRE-DU-QUÉBEC,Total établissement,,224651,36088,11267,7.8259260908,173433,3.1570039295,149575,11529,3556,4.7547691979,99502,3.945534791,75076,12851,1839,13.944636361,73931,2.0957387256,24559,7711
2022-2023,12,05,Estrie,CIUSSS DE L'ESTRIE - CENTRE HOSPITALIER UNIVERSITAIRE DE SHERBROOKE,Total établissement,,219601,32745,11458,8.7837554335,178383,3.2823093335,144237,10768,3980,5.3529678142,103428,4.2469782092,75364,15656,3653,15.349841547,74955,1.9511936977,21977,7478
2022-2023,12,06,Montréal,CENTRE HOSPITALIER DE L'UNIVERSITÉ DE MONTRÉAL,Total établissement,,62201,8715,5168,13.806387178,48077,3.0378572394,37192,2281,1944,7.3328656775,23243,4.8102512943,25009,9850,2623,23.433449902,24834,1.3790123084,6434,3224
2022-2023,12,06,Montréal,CENTRE HOSPITALIER UNIVERSITAIRE SAINTE-JUSTINE,Total établissement,,81806,0,1706,6.1023395696,65841,2.6831075368,55045,0,810,5.4063934003,40220,3.3557771355,26761,646,14,7.5338390236,25621,1.6271467524,0,896
2022-2023,12,06,Montréal,CENTRE UNIVERSITAIRE DE SANTÉ MCGILL,Total établissement,,159669,13003,7233,11.717589818,130665,2.8800094219,108859,3637,2175,6.74283956,80381,3.5617349837,50810,13755,6410,22.375852725,50284,1.7902436439,9366,5058
2022-2023,12,06,Montréal,CIUSSS DE L'EST-DE-L'ÎLE-DE-MONTRÉAL,Total établissement,,96594,18923,9707,13.44316749,73129,3.138352922,57240,4566,3292,5.3850666977,34121,4.3530971559,39354,14987,6025,25.163594623,39008,2.0757942673,14357,6415
2022-2023,12,06,Montréal,CIUSSS DE L'OUEST-DE-L'ÎLE-DE-MONTRÉAL,Total établissement,,95046,17178,10605,12.332583129,80838,2.6336002183,63651,5324,4075,5.9761034609,49565,3.2106079391,31395,11282,4478,25.219867327,31273,1.7190928899,11854,6530
2022-2023,12,06,Montréal,CIUSSS DU CENTRE-OUEST-DE-L'ÎLE-DE-MONTRÉAL,Total établissement,,80335,14960,4339,10.400936108,70268,2.2933485568,30549,1837,503,4.0992282526,21712,2.7563326348,49786,7879,1973,14.267703337,48556,2.0863234661,13123,3836
2022-2023,12,06,Montréal,CIUSSS DU CENTRE-SUD-DE-L'ÎLE-DE-MONTRÉAL,Total établissement,,71542,10575,7559,11.015551684,62299,2.1688064148,45439,2638,2791,4.8507288771,36276,2.8495722608,26103,9084,2107,21.747014871,26023,1.2198204473,7937,4768
2022-2023,12,06,Montréal,CIUSSS DU NORD-DE-L'ÎLE-DE-MONTRÉAL,Total établissement,,127997,20166,10087,10.821688197,99834,3.2008623509,90507,6434,4483,5.9735575701,62475,4.2265538304,37490,14326,3768,22.525869543,37359,1.4856110011,13732,5604
2022-2023,12,06,Montréal,INSTITUT DE CARDIOLOGIE DE MONTRÉAL,Total établissement,,17526,4831,537,8.982899787,17025,1.3677198564,10926,1998,461,3.7695716639,10432,1.6006169319,6600,1687,194,17.613327525,6593,0.9992104842,2833,76
2022-2023,12,07,Outaouais,CISSS DE L'OUTAOUAIS,Total établissement,,144368,18133,7900,9.1378268691,107131,2.9237506806,107549,8263,3538,4.4095399436,71070,2.9700348014,36819,10592,5346,22.949243001,36061,2.8325326761,9870,4362
2022-2023,12,08,Abitibi-Témiscamingue,CISSS DE L'ABITIBI-TÉMISCAMINGUE,Total établissement,,104840,11359,5582,6.1836365732,87673,2.9463138404,86171,6064,4105,4.7713553928,69169,3.2332258631,18669,2480,469,12.702340392,18504,1.8738204502,5295,1477
2022-2023,12,09,Côte-Nord,CISSS DE LA CÔTE-NORD,Total établissement,,94705,10273,4647,6.6021815433,75532,2.8300822683,75236,5671,3031,4.3945682807,56503,2.9811489065,19469,3387,1351,15.133281827,19029,2.3815185886,4602,1616
2022-2023,12,11,Gaspésie-Îles-de-la-Madeleine,CISSS DE LA GASPÉSIE,Total établissement,,76775,12547,3221,5.7276006115,67386,1.9850426646,61791,7382,2172,3.5420634298,52710,2.1391222201,14984,2716,931,14.740316041,14676,1.4316539096,5165,1049
2022-2023,12,11,Gaspésie-Îles-de-la-Madeleine,CISSS DES ÎLES,Total établissement,,15890,1938,428,4.4537096881,14002,1.849598113,13431,1321,262,3.2839272537,11559,1.9683983861,2459,234,19,10.843033754,2443,1.2874972711,617,166
2022-2023,12,12,Chaudière-Appalaches,CISSS DE CHAUDIÈRE-APPALACHES,Total établissement,,222245,33485,9376,6.1401810689,191009,1.7181019597,172071,15220,4965,3.3419801387,140896,2.0134813681,50174,11017,2115,15.73657028,50113,0.8876232991,18265,4411
2022-2023,12,13,Laval,CISSS DE LAVAL,Total établissement,,85630,14605,5371,9.3653545811,64404,3.099714338,56417,4075,1539,5.4632937176,35300,3.99373209,29213,6733,565,16.901128645,29104,2.015367628,10530,3832
2022-2023,12,14,Lanaudière,CISSS DE LANAUDIÈRE,Total établissement,,132699,21875,8060,10.952831088,94978,3.8104022393,89077,6712,4291,6.2412315905,51560,4.8365926914,43622,14726,3564,20.574011877,43418,2.5917744881,15163,3769
2022-2023,12,15,Laurentides,CISSS DES LAURENTIDES,Total établissement,,175620,27942,11432,12.398869629,130576,3.9891159129,116184,9525,3887,6.4915338601,71605,4.9261800852,59436,21766,7857,23.94638122,58971,2.8512942708,18417,7545
2022-2023,12,16,Montérégie,CISSS DE LA MONTÉRÉGIE-CENTRE,Total établissement,,129147,20178,8933,10.038760878,81072,3.9958009581,92264,7358,3590,5.4887757323,44325,4.6174804725,36883,11628,3628,21.420693733,36747,3.2459181248,12820,5343
2022-2023,12,16,Montérégie,CISSS DE LA MONTÉRÉGIE-EST,Total établissement,,126277,23006,7214,11.784810366,96350,3.9396105778,78640,7932,2691,5.7912899853,49064,4.7169912993,47637,14751,5885,21.679019547,47286,3.1329995782,15074,4523
2022-2023,12,16,Montérégie,CISSS DE LA MONTÉRÉGIE-OUEST,Total établissement,,89170,15624,4770,14.246243969,68728,2.5039229564,62340,5257,2254,6.0563756149,41967,3.0525271046,26830,11716,6238,33.275554189,26761,1.6435937351,10367,2516
2023-2024,12,01,Bas-Saint-Laurent,CISSS DU BAS-SAINT-LAURENT,Total établissement,,124612,21541,5119,4.7609136315,108687,1.9858063087,92579,10390,3032,3.335156341,77190,2.1758842575,32033,1567,206,8.8815137688,31497,1.5199804567,11151,2087
2023-2024,12,02,Saguenay-Lac-Saint-Jean,CIUSSS DU SAGUENAY - LAC-SAINT-JEAN,Total établissement,,163627,25847,8381,6.2706268967,140455,2.691889943,111185,10842,3363,3.8828047973,88897,3.0260054708,52442,5075,419,11.333172187,51558,2.1158034371,15005,5018
2023-2024,12,03,Capitale-Nationale,CHU DE QUÉBEC - UNIVERSITÉ LAVAL,Total établissement,,215951,37453,16531,9.2025721563,183231,2.0057783087,125996,10847,5285,4.3226360471,93727,2.6611840031,89955,18621,4188,16.037683379,89504,1.3194490997,26606,11246
2023-2024,12,03,Capitale-Nationale,CIUSSS DE LA CAPITALE-NATIONALE,Total établissement,,111739,13208,2106,3.9761519677,85214,1.914359358,93936,8277,1339,3.0109511825,67673,2.1285291648,17803,1162,250,9.0689509883,17541,1.0880944169,4931,767
2023-2024,12,03,Capitale-Nationale,INSTITUT UNIVERSITAIRE DE CARDIOLOGIE ET DE PNEUMOLOGIE DE QUÉBEC - UNIVERSITÉ LAVAL,Total établissement,,26810,8833,636,8.3402942517,25172,2.1644163709,14006,3009,366,4.2388176892,12399,2.7900931751,12804,1621,8,12.826804775,12773,1.5570597049,5824,270
2023-2024,12,04,Mauricie et Centre-du-Québec,CIUSSS DE LA MAURICIE-ET-DU-CENTRE-DU-QUÉBEC,Total établissement,,222648,38826,11230,7.4585893054,175684,3.0134008283,144774,12578,3508,4.6210280621,99081,3.7621886386,77874,10906,976,12.73384281,76603,2.0448924796,26248,7722
2023-2024,12,05,Estrie,CIUSSS DE L'ESTRIE - CENTRE HOSPITALIER UNIVERSITAIRE DE SHERBROOKE,Total établissement,,217525,34987,11438,8.8405461377,179475,3.357869968,142056,12408,4131,5.4576660789,104397,4.3255942221,75469,15418,3292,15.208172708,75078,2.0122359746,22579,7307
2023-2024,12,06,Montréal,CENTRE HOSPITALIER DE L'UNIVERSITÉ DE MONTRÉAL,Total établissement,,68368,10020,5230,12.895032622,51198,3.1138809133,40307,2705,1637,7.4692516533,23343,5.0892210727,28061,9524,1793,20.688659131,27855,1.4585096931,7315,3593
2023-2024,12,06,Montréal,CENTRE HOSPITALIER UNIVERSITAIRE SAINTE-JUSTINE,Total établissement,,72602,0,1690,5.2015940179,62612,1.9347552919,46162,0,719,4.3982719613,36972,2.5021694195,26440,420,5,6.6041262712,25640,1.1165635942,0,971
2023-2024,12,06,Montréal,CENTRE UNIVERSITAIRE DE SANTÉ MCGILL,Total établissement,,155869,13139,7310,11.427411938,133968,2.4807809804,104555,3884,2115,5.8924136871,83233,2.8932777297,51314,14099,6442,22.705264808,50735,1.8040619121,9255,5195
2023-2024,12,06,Montréal,CIUSSS DE L'EST-DE-L'ÎLE-DE-MONTRÉAL,Total établissement,,96903,18961,9424,12.567939902,74922,3.0793110576,56591,4767,3511,5.5004350957,34811,4.3499557691,40312,14306,4408,22.489480993,40111,1.976560863,14194,5913
2023-2024,12,06,Montréal,CIUSSS DE L'OUEST-DE-L'ÎLE-DE-MONTRÉAL,Total établissement,,94613,18038,10705,13.143622294,80450,2.7568396658,62349,5831,4087,6.1793477709,48303,3.4045025844,32264,12519,5049,26.601828104,32147,1.7836831673,12207,6618
2023-2024,12,06,Montréal,CIUSSS DU CENTRE-OUEST-DE-L'ÎLE-DE-MONTRÉAL,Total établissement,,83046,15898,4541,11.279310108,71189,2.5682792597,29932,1955,467,4.0980270465,19554,3.0734098877,53114,9010,2702,15.326268812,51635,2.376987998,13943,4074
2023-2024,12,06,Montréal,CIUSSS DU CENTRE-SUD-DE-L'ÎLE-DE-MONTRÉAL,Total établissement,,74334,11996,7704,11.522655458,63011,2.2793351558,46484,3254,2929,5.106474211,35240,3.033402699,27850,10209,2301,22.231803361,27771,1.3224614306,8742,4775
2023-2024,12,06,Montréal,CIUSSS DU NORD-DE-L'ÎLE-DE-MONTRÉAL,Total établissement,,128471,21364,9798,11.150800933,97859,3.3056180775,89743,6970,4017,6.1305565337,59233,4.4352782139,38728,14801,4082,22.784032526,38626,1.5732834101,14394,5781
2023-2024,12,06,Montréal,INSTITUT DE CARDIOLOGIE DE MONTRÉAL,Total établissement,,18505,5080,489,8.8594338917,17885,1.5739389308,11772,2319,408,3.9975964152,11156,1.8507933947,6733,1666,136,17.359886999,6729,1.1149422896,2761,81
2023-2024,12,07,Outaouais,CISSS DE L'OUTAOUAIS,Total établissement,,143222,19606,7881,9.7240561487,106906,3.4873371181,104468,8821,3343,5.1166054704,69183,3.4287859453,38754,11570,4937,22.144223292,37723,3.5947184447,10785,4538
2023-2024,12,08,Abitibi-Témiscamingue,CISSS DE L'ABITIBI-TÉMISCAMINGUE,Total établissement,,103099,12141,5429,6.2595599672,87595,2.8622611609,83158,6494,3891,4.8381108185,67852,3.1530417878,19941,2372,445,12.187290187,19743,1.8629172365,5647,1538
2023-2024,12,09,Côte-Nord,CISSS DE LA CÔTE-NORD,Total établissement,,92525,10647,4956,6.4528264043,74176,2.7762591487,72958,6086,3155,4.0363727076,55055,2.9209584405,19567,3580,1372,15.462875405,19121,2.3596271987,4561,1801
2023-2024,12,11,Gaspésie-Îles-de-la-Madeleine,CISSS DE LA GASPÉSIE,Total établissement,,75797,13042,3111,5.6584157355,67565,1.8961429405,60930,7812,2101,3.4527502052,52920,2.0383337952,14867,2852,771,14.697979922,14645,1.3823334471,5230,1010
2023-2024,12,11,Gaspésie-Îles-de-la-Madeleine,CISSS DES ÎLES,Total établissement,,15533,2175,476,4.0391516628,13851,1.5217352137,12667,1400,281,2.8855125962,11012,1.5975729003,2866,167,4,9.1379465186,2839,1.2275736762,775,195
2023-2024,12,12,Chaudière-Appalaches,CISSS DE CHAUDIÈRE-APPALACHES,Total établissement,,220688,34842,9301,6.0125343345,190596,1.8776478855,172179,16735,4939,3.4502228269,142153,2.2065228428,48509,9168,1847,15.10726383,48443,0.9125845782,18107,4362
2023-2024,12,13,Laval,CISSS DE LAVAL,Total établissement,,83289,16125,5246,10.02408507,65184,2.9930271104,52847,4797,1295,5.472088219,34815,3.8171035872,30442,7504,981,17.92630495,30369,2.0483064236,11328,3951
2023-2024,12,14,Lanaudière,CISSS DE LANAUDIÈRE,Total établissement,,134274,24250,8460,10.765661556,97973,3.8931594646,88195,7792,4504,6.1896471928,52146,4.862619371,46079,14766,2769,19.524132589,45827,2.7900225304,16458,3956
2023-2024,12,15,Laurentides,CISSS DES LAURENTIDES,Total établissement,,174791,30901,11878,12.152784704,133173,3.9220902281,113259,10831,3777,6.4996517152,72162,4.897883412,61532,21153,6893,22.558235349,61011,2.7679510116,20070,8101
2023-2024,12,16,Montérégie,CISSS DE LA MONTÉRÉGIE-CENTRE,Total établissement,,125094,22367,8594,10.567410363,80924,4.4829103542,85750,8210,3091,5.9575366667,41840,5.280107619,39344,12792,3221,20.614601026,39084,3.6294988927,14157,5503
2023-2024,12,16,Montérégie,CISSS DE LA MONTÉRÉGIE-EST,Total établissement,,130434,25349,7137,10.8662664,101054,4.0871946215,73642,8683,2477,5.7748441597,44925,4.779156279,56792,13973,3872,17.468296909,56129,3.5333565438,16666,4660
2023-2024,12,16,Montérégie,CISSS DE LA MONTÉRÉGIE-OUEST,Total établissement,,90958,17228,5361,13.771147642,72602,2.6602173723,61299,5749,2418,6.6354648571,43084,3.4594240192,29659,12284,5765,28.519123603,29518,1.4937081517,11479,2943
2024-2025,12,01,Bas-Saint-Laurent,CISSS DU BAS-SAINT-LAURENT,Total établissement,,136214,23414,5264,4.8126209086,118229,2.0725915948,104649,11803,3181,3.3947326433,87116,2.2818821871,31565,2025,214,9.513415747,31113,1.4865806272,11611,2083
2024-2025,12,02,Saguenay-Lac-Saint-Jean,CIUSSS DU SAGUENAY - LAC-SAINT-JEAN,Total établissement,,175855,28240,8414,6.3903222794,149916,2.8936793104,121034,11974,3309,4.1263401331,96027,3.2779960439,54821,5248,378,11.388750165,53889,2.2088496982,16266,5105
2024-2025,12,03,Capitale-Nationale,CHU DE QUÉBEC - UNIVERSITÉ LAVAL,Total établissement,,229818,41023,17470,9.0014291925,193433,2.1760314151,133775,11747,5734,4.5496343155,98045,2.8974204164,96043,19127,2685,15.20218156,95388,1.4345483709,29276,11736
2024-2025,12,03,Capitale-Nationale,CIUSSS DE LA CAPITALE-NATIONALE,Total établissement,,121999,14604,2379,3.9635253317,93404,1.9644698895,104158,9327,1573,3.1020606008,75828,2.1624319476,17841,1126,183,8.9928646875,17576,1.1104037229,5277,806
2024-2025,12,03,Capitale-Nationale,INSTITUT UNIVERSITAIRE DE CARDIOLOGIE ET DE PNEUMOLOGIE DE QUÉBEC - UNIVERSITÉ LAVAL,Total établissement,,28743,9651,570,8.0727177052,26803,2.1119830595,15034,3375,303,4.0939871477,13141,2.6736753714,13709,1536,0,12.43599987,13662,1.5717108688,6276,267
2024-2025,12,04,Mauricie et Centre-du-Québec,CIUSSS DE LA MAURICIE-ET-DU-CENTRE-DU-QUÉBEC,Total établissement,,235692,42234,11822,7.4069611859,185383,3.1563094527,151969,14293,3584,4.8289890171,103163,3.9638948261,83723,10141,690,12.086342629,82220,2.1430167032,27941,8238
2024-2025,12,05,Estrie,CIUSSS DE L'ESTRIE - CENTRE HOSPITALIER UNIVERSITAIRE DE SHERBROOKE,Total établissement,,223948,36711,11130,8.6965110638,181867,3.6845331158,147927,13349,4068,5.8430282598,106397,4.738019232,76021,13474,1907,14.249018276,75470,2.1993368483,23362,7062
2024-2025,12,06,Montréal,CENTRE HOSPITALIER DE L'UNIVERSITÉ DE MONTRÉAL,Total établissement,,74220,11085,6364,12.177589681,53258,3.1781442851,44790,3093,2358,7.5549628947,24035,5.1944603472,29430,9124,1050,19.212841252,29223,1.5197876292,7992,4006
2024-2025,12,06,Montréal,CENTRE HOSPITALIER UNIVERSITAIRE SAINTE-JUSTINE,Total établissement,,77508,1,1847,5.1373579645,65445,1.8524657006,50160,0,696,4.3370859417,38804,2.3953077647,27348,469,9,6.6051671156,26641,1.0617880439,1,1151
2024-2025,12,06,Montréal,CENTRE UNIVERSITAIRE DE SANTÉ MCGILL,Total établissement,,168636,15058,8237,11.56895157,144089,2.511306062,113722,4311,2277,5.9576420374,89704,3.0093722471,54914,15388,7382,23.189473525,54385,1.6897830488,10747,5960
2024-2025,12,06,Montréal,CIUSSS DE L'EST-DE-L'ÎLE-DE-MONTRÉAL,Total établissement,,105806,20692,9782,13.091461089,76977,3.4184707553,62172,5224,3585,5.4053248336,33673,4.8856561472,43634,16033,5612,24.043069083,43304,2.2775938456,15468,6197
2024-2025,12,06,Montréal,CIUSSS DE L'OUEST-DE-L'ÎLE-DE-MONTRÉAL,Total établissement,,102732,20164,10926,12.490885676,85947,3.1049327686,66174,6062,4088,6.4754211204,49527,3.9561822788,36558,12595,3924,23.379537994,36420,1.947331602,14102,6838
2024-2025,12,06,Montréal,CIUSSS DU CENTRE-OUEST-DE-L'ÎLE-DE-MONTRÉAL,Total établissement,,89703,17089,4602,11.179665916,77395,2.5192856594,31675,1993,453,3.7704825485,20737,2.8908876378,58028,9905,3391,15.224021799,56658,2.3832782073,15096,4149
2024-2025,12,06,Montréal,CIUSSS DU CENTRE-SUD-DE-L'ÎLE-DE-MONTRÉAL,Total établissement,,78071,12889,7706,10.93514431,65581,2.3182661518,49769,3499,3035,5.3207677247,37361,3.1335860107,28302,9085,1793,20.808012243,28220,1.2388485314,9390,4671
2024-2025,12,06,Montréal,CIUSSS DU NORD-DE-L'ÎLE-DE-MONTRÉAL,Total établissement,,136790,22475,9918,10.831065792,102238,3.3884645794,95540,7162,3956,5.9478821465,61126,4.5696736659,41250,15259,3875,22.141111017,41112,1.6322234181,15313,5962
2024-2025,12,06,Montréal,INSTITUT DE CARDIOLOGIE DE MONTRÉAL,Total établissement,,19632,5309,469,7.4764669219,18959,1.6445314744,13070,2603,417,3.6129592153,12400,1.8945264113,6562,1193,74,15.171688764,6559,1.1719080229,2706,52
2024-2025,12,07,Outaouais,CISSS DE L'OUTAOUAIS,Total établissement,,157551,22071,8501,9.7397878853,117486,4.2292213824,116027,9865,3462,5.5765176688,77393,4.0846400371,41524,12445,4201,21.372861611,40093,4.508312098,12206,5039
2024-2025,12,08,Abitibi-Témiscamingue,CISSS DE L'ABITIBI-TÉMISCAMINGUE,Total établissement,,112211,13632,5794,6.4405327959,93941,3.2300989333,90985,7520,4243,5.1075477307,72954,3.563638122,21226,2715,400,12.154357641,20987,2.0706660472,6112,1551
2024-2025,12,09,Côte-Nord,CISSS DE LA CÔTE-NORD,Total établissement,,96035,11327,5265,6.8017701851,77809,3.2605567943,75731,6395,3144,4.8133632785,57970,3.4778245309,20304,3380,1067,14.218241986,19839,2.6256956276,4932,2121
2024-2025,12,11,Gaspésie-Îles-de-la-Madeleine,CISSS DE LA GASPÉSIE,Total établissement,,82017,13892,3283,5.1123620171,72516,2.0544280304,65739,8539,2156,3.5636430049,56506,2.221187691,16278,1933,279,11.366892005,16010,1.4658632972,5353,1127
2024-2025,12,11,Gaspésie-Îles-de-la-Madeleine,CISSS DES ÎLES,Total établissement,,14888,2259,446,4.8589109238,12765,1.8608061322,11918,1437,222,3.3390284071,9838,1.979989553,2970,312,63,10.957887299,2927,1.4602162814,822,224
2024-2025,12,12,Chaudière-Appalaches,CISSS DE CHAUDIÈRE-APPALACHES,Total établissement,,229704,37340,9741,6.4370645507,199594,1.9936722366,178502,18319,5003,3.6239208431,148469,2.3471890391,51202,10553,2856,16.24433337,51125,0.9670456126,19021,4738
2024-2025,12,13,Laval,CISSS DE LAVAL,Total établissement,,85984,16703,5655,11.002881253,66532,3.7259846139,53649,4988,1232,6.4194124722,34342,4.7515791726,32335,8992,1086,18.607598019,32190,2.6318259207,11715,4423
2024-2025,12,14,Lanaudière,CISSS DE LANAUDIÈRE,Total établissement,,147288,27177,9095,10.117993879,108764,3.4208263406,97063,8598,4688,5.7219029794,58762,4.2827136679,50225,15315,2134,18.613718539,50002,2.4079423934,18579,4407
2024-2025,12,15,Laurentides,CISSS DES LAURENTIDES,Total établissement,,192471,34648,12195,11.985461686,146828,3.882342376,124698,12279,3924,6.3208812469,79568,4.8331567583,67773,22452,7543,22.40792862,67260,2.7575371609,22369,8271
2024-2025,12,16,Montérégie,CISSS DE LA MONTÉRÉGIE-CENTRE,Total établissement,,127874,23926,9297,11.530107938,82842,4.9911693981,87051,8891,3163,6.522206095,42130,6.0320745378,40823,14900,3837,22.208962098,40712,3.9140095058,15035,6134
2024-2025,12,16,Montérégie,CISSS DE LA MONTÉRÉGIE-EST,Total établissement,,134273,27485,7598,11.010094494,100594,4.5677285811,73565,9372,2545,5.9137543518,40545,5.4367193516,60708,14471,3785,17.185759359,60049,3.9809872401,18113,5053
2024-2025,12,16,Montérégie,CISSS DE LA MONTÉRÉGIE-OUEST,Total établissement,,92864,16691,5717,12.53767546,74827,2.3825926508,59337,4972,2393,5.7875398618,41897,3.2960833844,33527,11711,5243,24.484249742,32930,1.2203539241,11719,3324
2020-2021,12,01,Bas-Saint-Laurent,CISSS DU BAS-SAINT-LAURENT,CENTRE HOSPITALIER RÉGIONAL DU GRAND-PORTAGE,51218352,14257,2718,792,4.8221752667,12237,1.4932254638,9571,914,450,2.6725182264,7574,1.727228567,4686,95,0,9.212778667,4663,1.1131397884,1804,342
2020-2021,12,01,Bas-Saint-Laurent,CISSS DU BAS-SAINT-LAURENT,CENTRE MULTISERVICES DE SANTÉ ET DE SERVICES SOCIAUX DE TROIS-PISTOLES,51236156,5853,898,200,2.9986583329,5294,1.0571413655,4848,553,157,2.2364098597,4301,1.1616650521,1005,17,0,6.6756539525,993,0.6044159114,345,43
2020-2021,12,01,Bas-Saint-Laurent,CISSS DU BAS-SAINT-LAURENT,CLSC DE POHÉNÉGAMOOK,51219418,5934,857,170,1.3941456484,5142,0.5578793379,5514,720,155,1.0535756458,4729,0.567195026,420,1,0,5.865343254,413,0.4512113263,137,15
2020-2021,12,01,Bas-Saint-Laurent,CISSS DU BAS-SAINT-LAURENT,HÔPITAL D'AMQUI,51226892,10352,1608,342,3.6571853802,9633,1.0872561334,5989,578,198,2.5353729986,5369,1.2147016308,4363,17,0,5.1970740698,4264,0.9267836017,1030,144
2020-2021,12,01,Bas-Saint-Laurent,CISSS DU BAS-SAINT-LAURENT,HÔPITAL DE MATANE,51218980,13206,2329,687,4.0753008313,11887,1.7166770421,9814,1109,387,3.2139324491,8543,1.945945706,3392,63,0,6.5674792813,3344,1.1309586822,1220,300
2020-2021,12,01,Bas-Saint-Laurent,CISSS DU BAS-SAINT-LAURENT,HÔPITAL DE NOTRE-DAME-DU-LAC,51221877,8668,1502,273,3.3247814118,7967,0.846969025,6515,767,135,1.7192401296,5830,0.9732159806,2153,42,0,8.1831657377,2137,0.502551734,735,138
2020-2021,12,01,Bas-Saint-Laurent,CISSS DU BAS-SAINT-LAURENT,HÔPITAL NOTRE-DAME-DE-FATIMA,51221141,10572,1792,334,3.6738191291,9867,1.0816161335,8070,850,163,2.3181697301,7381,1.161425394,2502,10,0,8.0463573586,2486,0.84466032,942,171
2020-2021,12,01,Bas-Saint-Laurent,CISSS DU BAS-SAINT-LAURENT,HÔPITAL RÉGIONAL DE RIMOUSKI,51227882,24118,4400,1500,4.5670481706,20014,1.5080331129,16376,1603,956,3.0870431153,12305,1.7479980812,7742,107,2,7.6975781093,7709,1.125004324,2797,544
2020-2021,12,02,Saguenay-Lac-Saint-Jean,CIUSSS DU SAGUENAY - LAC-SAINT-JEAN,HÔPITAL D'ALMA,51219400,21735,3328,991,4.1795821512,18191,1.7794425204,15638,1578,386,2.7123820004,12177,1.9069534779,6097,157,13,7.9427568203,6014,1.5212614548,1750,605
2020-2021,12,02,Saguenay-Lac-Saint-Jean,CIUSSS DU SAGUENAY - LAC-SAINT-JEAN,HÔPITAL DE CHICOUTIMI,51218394,39211,6053,2602,6.4792323016,35623,1.3555018683,20056,1443,743,2.3601220056,16617,1.6034089085,19155,1857,119,10.792094536,19006,1.1387560361,4610,1859
2020-2021,12,02,Saguenay-Lac-Saint-Jean,CIUSSS DU SAGUENAY - LAC-SAINT-JEAN,HÔPITAL DE DOLBEAU-MISTASSINI,51219384,13248,2241,548,4.3562756223,12175,1.4328725987,10596,1252,253,2.6938237962,9533,1.5469308659,2652,259,58,10.99856052,2642,1.0213217049,989,295
2020-2021,12,02,Saguenay-Lac-Saint-Jean,CIUSSS DU SAGUENAY - LAC-SAINT-JEAN,HÔPITAL DE LA BAIE,51221364,11344,1638,391,4.5554487688,10465,1.8005049371,8541,730,212,2.9963999467,7679,2.0390858908,2803,89,2,9.3060145875,2786,1.1429086903,908,179
2020-2021,12,02,Saguenay-Lac-Saint-Jean,CIUSSS DU SAGUENAY - LAC-SAINT-JEAN,HÔPITAL ET CENTRE D'HÉBERGEMENT DE ROBERVAL,51228203,17869,2492,1167,4.1915550208,16474,1.5948089245,11899,903,350,2.6813298737,10556,1.7733312808,5970,91,1,7.2016335846,5918,1.2763766851,1589,817
2020-2021,12,02,Saguenay-Lac-Saint-Jean,CIUSSS DU SAGUENAY - LAC-SAINT-JEAN,HÔPITAL ET CENTRE DE RÉADAPTATION DE JONQUIÈRE,51224541,19924,3356,943,6.1282863911,16947,2.4661022436,12394,1062,387,3.8118106207,9541,2.7770952264,7530,244,5,9.9410886085,7406,2.0654562742,2294,556
2020-2021,12,03,Capitale-Nationale,CHU DE QUÉBEC - UNIVERSITÉ LAVAL,CENTRE HOSPITALIER DE L'UNIVERSITÉ LAVAL,51217594,56933,5469,5982,7.6808033371,49849,1.4703356637,31542,973,1659,4.0077637224,24509,2.0407268192,25391,3024,676,12.243641174,25340,0.9186499167,4496,4323
2020-2021,12,03,Capitale-Nationale,CHU DE QUÉBEC - UNIVERSITÉ LAVAL,HÔPITAL DE L'ENFANT-JÉSUS,51233914,48370,7808,6568,10.546685158,44179,1.3513533013,26127,2145,1495,3.6022119519,21949,1.7801252019,22243,5705,1693,18.703779591,22230,0.9280013245,5663,5073
2020-2021,12,03,Capitale-Nationale,CHU DE QUÉBEC - UNIVERSITÉ LAVAL,HÔPITAL DU SAINT-SACREMENT,51217529,24332,5098,774,7.5245558547,21110,1.4885229486,16998,1863,321,3.0364746343,13790,1.7736924905,7334,1944,419,17.926574478,7320,0.9512978142,3235,453
2020-2021,12,03,Capitale-Nationale,CHU DE QUÉBEC - UNIVERSITÉ LAVAL,HÔPITAL SAINT-FRANÇOIS D'ASSISE,51217602,32420,7109,1057,10.521271249,27886,1.712996665,18271,1791,430,4.084555139,13772,2.273536483,14149,4210,795,18.833183048,14114,1.1660394329,5318,627
2020-2021,12,03,Capitale-Nationale,CHU DE QUÉBEC - UNIVERSITÉ LAVAL,L'HÔTEL-DIEU DE QUÉBEC,51217586,14347,3470,714,8.6478586309,13161,1.3467337208,6653,820,258,3.3424591245,5527,1.5304432282,7694,1105,45,13.235436343,7634,1.2137284226,2650,456
2020-2021,12,03,Capitale-Nationale,CIUSSS DE LA CAPITALE-NATIONALE,CENTRE MULTISERVICES DE SANTÉ ET DE SERVICES SOCIAUX CHAUVEAU,51225001,18537,1230,320,2.4352300055,14758,1.2537523904,16307,1027,255,2.1805063436,12549,1.3122205621,2230,0,0,4.2979110613,2209,0.9216034153,203,65
2020-2021,12,03,Capitale-Nationale,CIUSSS DE LA CAPITALE-NATIONALE,CENTRE MULTISERVICES DE SANTÉ ET DE SERVICES SOCIAUX DE BAIE-SAINT-PAUL,51244804,8247,1603,271,4.1726264096,6619,1.3224379312,6155,855,95,2.3921620634,4545,1.5072098765,2092,89,3,9.4110384799,2074,0.9175254473,748,176
2020-2021,12,03,Capitale-Nationale,CIUSSS DE LA CAPITALE-NATIONALE,CENTRE MULTISERVICES DE SANTÉ ET DE SERVICES SOCIAUX DE SAINT-MARC-DES-CARRIÈRES,51247344,10514,1550,316,2.9468818295,8916,1.1771405339,8296,800,192,2.0097708065,6722,1.3528205891,2218,37,0,6.4519643573,2194,0.638890155,750,124
2020-2021,12,03,Capitale-Nationale,CIUSSS DE LA CAPITALE-NATIONALE,CENTRE MULTISERVICES DE SANTÉ ET DE SERVICES SOCIAUX DE SAINT-RAYMOND,51247302,13427,1831,306,3.6998241313,11384,1.6640081108,10376,839,187,2.6537783775,8368,1.8981044853,3051,75,1,7.2572711133,3016,1.0144993369,992,119
2020-2021,12,03,Capitale-Nationale,CIUSSS DE LA CAPITALE-NATIONALE,CENTRE MULTISERVICES DE SANTÉ ET DE SERVICES SOCIAUX DE SAINTE-ANNE-DE-BEAUPRÉ,51225357,10628,1196,215,2.8655627431,7938,1.1295626522,9247,731,162,2.143996191,6570,1.1985182648,1381,41,3,7.6970804168,1368,0.7983942495,465,53
2020-2021,12,03,Capitale-Nationale,CIUSSS DE LA CAPITALE-NATIONALE,HÔPITAL ET CLSC DE LA MALBAIE,51228690,9782,1591,377,5.3131564211,8241,1.2673730602,7696,882,232,2.5684920377,6160,1.4607218164,2086,392,84,15.439204884,2081,0.6950384431,709,145
2020-2021,12,03,Capitale-Nationale,INSTITUT UNIVERSITAIRE DE CARDIOLOGIE ET DE PNEUMOLOGIE DE QUÉBEC - UNIVERSITÉ LAVAL,INSTITUT UNIVERSITAIRE DE CARDIOLOGIE ET DE PNEUMOLOGIE DE QUÉBEC,51232130,20333,6208,539,7.7425812991,19554,1.4213759901,9793,1834,312,3.6796868795,9024,1.8291980644,10540,786,1,11.51752675,10530,1.0718806057,4374,227
2020-2021,12,04,Mauricie et Centre-du-Québec,CIUSSS DE LA MAURICIE-ET-DU-CENTRE-DU-QUÉBEC,CENTRE MULTISERVICES DE SANTÉ ET DE SERVICES SOCIAUX AVELLIN-DALCOURT,51233583,14484,2101,413,4.5620382836,12944,2.2816937921,11844,1034,259,3.4482403186,10314,2.5378926702,2640,93,3,9.5589409722,2630,1.2769655682,1067,154
2020-2021,12,04,Mauricie et Centre-du-Québec,CIUSSS DE LA MAURICIE-ET-DU-CENTRE-DU-QUÉBEC,CENTRE MULTISERVICES DE SANTÉ ET DE SERVICES SOCIAUX CHRIST-ROI,51246338,13049,1445,457,3.8535093153,11191,1.8850558236,10771,687,303,2.4175578199,8930,1.9829398407,2278,194,23,10.643076285,2261,1.4984550838,758,154
2020-2021,12,04,Mauricie et Centre-du-Québec,CIUSSS DE LA MAURICIE-ET-DU-CENTRE-DU-QUÉBEC,CENTRE MULTISERVICES DE SANTÉ ET DE SERVICES SOCIAUX DE FORTIERVILLE,51219160,7764,750,192,1.6049883007,7061,0.8128863161,7158,610,178,1.4674135,6455,0.8395453567,606,0,0,3.2300055006,606,0.5289191419,140,14
2020-2021,12,04,Mauricie et Centre-du-Québec,CIUSSS DE LA MAURICIE-ET-DU-CENTRE-DU-QUÉBEC,CENTRE MULTISERVICES DE SANTÉ ET DE SERVICES SOCIAUX DU HAUT-SAINT-MAURICE,51219731,9073,1375,519,4.1668373501,7871,1.8486509903,6745,714,272,2.9217053785,5572,2.0062913775,2328,59,0,7.7744039948,2299,1.4665839012,661,247
2020-2021,12,04,Mauricie et Centre-du-Québec,CIUSSS DE LA MAURICIE-ET-DU-CENTRE-DU-QUÉBEC,HÔPITAL DU CENTRE-DE-LA-MAURICIE,51220051,25557,4717,1933,5.7288226644,21308,1.7123159272,14129,1067,414,3.0580571087,9958,2.2155544955,11428,361,2,9.0308218362,11350,1.2707961331,3650,1519
2020-2021,12,04,Mauricie et Centre-du-Québec,CIUSSS DE LA MAURICIE-ET-DU-CENTRE-DU-QUÉBEC,HÔPITAL SAINTE-CROIX,51228781,30907,4464,2253,6.8885630907,26533,2.0567432275,18612,1125,921,4.1752489433,14387,2.5322605091,12295,1038,46,10.99594031,12146,1.493490541,3339,1332
2020-2021,12,04,Mauricie et Centre-du-Québec,CIUSSS DE LA MAURICIE-ET-DU-CENTRE-DU-QUÉBEC,HÔTEL-DIEU D'ARTHABASKA,51228039,26091,4404,1575,4.910992935,21505,1.5700297734,14649,1224,377,2.6977677657,10210,1.9444985853,11442,280,9,7.7445478646,11295,1.2315325119,3180,1198
2020-2021,12,04,Mauricie et Centre-du-Québec,CIUSSS DE LA MAURICIE-ET-DU-CENTRE-DU-QUÉBEC,PAVILLON SAINTE-MARIE,51220168,45296,9424,3320,9.2060404831,37341,2.1425478473,23818,1924,918,3.9968767785,15995,3.0410637873,21478,4186,331,14.982735758,21346,1.46927124,7500,2402
2020-2021,12,05,Estrie,CIUSSS DE L'ESTRIE - CENTRE HOSPITALIER UNIVERSITAIRE DE SHERBROOKE,CENTRE DE SANTÉ ET DE SERVICES SOCIAUX DU GRANIT,51223832,10697,1504,438,6.433955003,9342,2.9966486477,8275,745,265,4.7188281302,6928,3.275032076,2422,295,24,12.293853794,2414,2.1977089662,759,173
2020-2021,12,05,Estrie,CIUSSS DE L'ESTRIE - CENTRE HOSPITALIER UNIVERSITAIRE DE SHERBROOKE,CENTRE MULTISERVICES DE SANTÉ ET DE SERVICES SOCIAUX DE LA MRC DE COATICOOK,51247617,10074,744,379,2.8491723744,8879,1.5594209496,7694,394,269,2.1428967016,6542,1.617286168,2380,23,1,5.1324013772,2337,1.3974379546,350,110
2020-2021,12,05,Estrie,CIUSSS DE L'ESTRIE - CENTRE HOSPITALIER UNIVERSITAIRE DE SHERBROOKE,CENTRE MULTISERVICES DE SANTÉ ET DE SERVICES SOCIAUX DE MEMPHRÉMAGOG,51219046,16186,3144,604,6.2127671204,13601,2.5091689541,10907,1182,270,3.6910288245,8460,2.6913869188,5279,604,57,11.422958368,5141,2.2093121204,1962,334
2020-2021,12,05,Estrie,CIUSSS DE L'ESTRIE - CENTRE HOSPITALIER UNIVERSITAIRE DE SHERBROOKE,CENTRE MULTISERVICES DE SANTÉ ET DE SERVICES SOCIAUX DES SOURCES,51247583,11523,1425,453,3.8898297608,9382,2.2387387787,9919,877,324,3.0324867538,7789,2.3909296943,1604,91,4,9.1915662233,1593,1.4945987654,548,129
2020-2021,12,05,Estrie,CIUSSS DE L'ESTRIE - CENTRE HOSPITALIER UNIVERSITAIRE DE SHERBROOKE,CHUS - HÔPITAL FLEURIMONT,51216687,33600,4761,789,7.2761066468,30949,1.6320026495,17018,811,343,4.4688134132,14372,2.5166388348,16582,1302,69,10.157213645,16577,0.8650368985,3950,446
2020-2021,12,05,Estrie,CIUSSS DE L'ESTRIE - CENTRE HOSPITALIER UNIVERSITAIRE DE SHERBROOKE,CHUS - HÔTEL-DIEU DE SHERBROOKE,51216695,36946,6777,5075,9.2894896155,32699,1.7872778984,16423,1334,1005,4.0376555238,12205,2.5155755838,20523,3323,670,13.492134028,20494,1.3535473797,5443,4070
2020-2021,12,05,Estrie,CIUSSS DE L'ESTRIE - CENTRE HOSPITALIER UNIVERSITAIRE DE SHERBROOKE,HÔPITAL BROME-MISSISQUOI-PERKINS,51229185,20222,3062,667,8.2732000489,17728,2.3066244861,13968,1007,335,4.1384151871,11506,2.5959637001,6254,1512,451,17.508037745,6222,1.7715655023,2055,332
2020-2021,12,05,Estrie,CIUSSS DE L'ESTRIE - CENTRE HOSPITALIER UNIVERSITAIRE DE SHERBROOKE,HÔPITAL DE GRANBY,51228120,28808,4498,2070,8.878904712,24634,2.2937176035,18896,1425,796,4.3310091201,14759,2.7923105676,9912,2619,508,17.548904218,9875,1.5485293952,3073,1274
2020-2021,12,06,Montréal,CENTRE HOSPITALIER DE L'UNIVERSITÉ DE MONTRÉAL,CENTRE HOSPITALIER DE L'UNIVERSITÉ DE MONTRÉAL,51236297,47576,6912,3719,12.802673529,41917,2.1010792823,27917,1912,1561,5.7383659598,22345,2.8042296934,19659,7422,1781,22.834428676,19572,1.2983051184,5000,2158
2020-2021,12,06,Montréal,CENTRE HOSPITALIER UNIVERSITAIRE SAINTE-JUSTINE,CHU SAINTE-JUSTINE,51222800,44450,0,1516,4.1869820147,42868,1.0237273854,30425,0,744,3.3673456313,28959,1.1467989418,14025,48,0,5.9650523866,13909,0.7674883169,0,772
2020-2021,12,06,Montréal,CENTRE UNIVERSITAIRE DE SANTÉ MCGILL,HÔPITAL DE LACHINE,51228310,11854,2111,596,9.799658929,10983,2.0263289478,6777,641,156,3.8056250307,6046,2.1504185504,5077,1209,332,17.800755586,4937,1.8743650553,1470,440
2020-2021,12,06,Montréal,CENTRE UNIVERSITAIRE DE SANTÉ MCGILL,HÔPITAL GÉNÉRAL DE MONTRÉAL,51248219,22650,3883,2915,12.823081359,20922,1.1984544578,6612,471,416,4.5468526501,5038,1.6879258193,16038,3171,921,16.235129259,15884,1.043206616,3412,2499
2020-2021,12,06,Montréal,CENTRE UNIVERSITAIRE DE SANTÉ MCGILL,HÔPITAL ROYAL VICTORIA,51223295,35968,5430,1046,13.333393904,31486,2.5797669158,21695,1337,512,6.2276095875,17259,3.1255380607,14273,5169,1839,24.134205979,14227,1.9176832587,4093,534
2020-2021,12,06,Montréal,CENTRE UNIVERSITAIRE DE SANTÉ MCGILL,L'HÔPITAL DE MONTRÉAL POUR ENFANTS,51223279,36492,3,1719,4.6870070837,35959,0.9232675099,25211,0,627,3.5628948894,24698,1.0224587461,11281,163,5,7.1991950576,11261,0.7057179893,3,1092
2020-2021,12,06,Montréal,CIUSSS DE L'EST-DE-L'ÎLE-DE-MONTRÉAL,HÔPITAL MAISONNEUVE-ROSEMONT,12934659,49363,9418,4408,13.829516327,41168,2.5864922661,26436,1937,1073,5.0844115873,18404,3.5394148766,22927,8532,2824,23.913067986,22764,1.816083387,7481,3335
2020-2021,12,06,Montréal,CIUSSS DE L'EST-DE-L'ÎLE-DE-MONTRÉAL,HÔPITAL SANTA CABRINI,51235919,26902,6690,1259,14.743887639,24240,2.6722928126,15567,1530,486,5.2216376523,12932,3.586383476,11335,4899,2089,27.821334975,11308,1.6269248909,5160,773
2020-2021,12,06,Montréal,CIUSSS DE L'EST-DE-L'ÎLE-DE-MONTRÉAL,INSTITUT UNIVERSITAIRE EN SANTÉ MENTALE DE MONTRÉAL,51235307,3698,167,3681,15.942619133,3576,1.1609852722,1714,50,1704,3.5594361792,1592,1.3252372976,1984,893,346,26.640590698,1984,1.0291862679,117,1977
2020-2021,12,06,Montréal,CIUSSS DE L'OUEST-DE-L'ÎLE-DE-MONTRÉAL,CENTRE HOSPITALIER DE ST. MARY,51248243,27287,4878,2304,8.8457081822,26534,1.4386422975,17691,1453,794,4.1674804515,16947,1.6204953023,9596,2355,277,17.470398343,9587,1.1171796008,3425,1510
2020-2021,12,06,Montréal,CIUSSS DE L'OUEST-DE-L'ÎLE-DE-MONTRÉAL,HÔPITAL DE LASALLE,51224392,20612,2634,713,8.3170449522,18432,2.82217038,15012,822,281,5.2249883427,12860,3.2546716779,5600,1471,68,16.605965278,5572,1.8239710457,1812,432
2020-2021,12,06,Montréal,CIUSSS DE L'OUEST-DE-L'ÎLE-DE-MONTRÉAL,HÔPITAL DOUGLAS,51235190,4837,137,4660,12.710104116,4446,2.5325104963,1921,40,1766,3.7770229626,1533,2.284602631,2916,778,115,18.595031722,2913,2.6629748827,97,2894
2020-2021,12,06,Montréal,CIUSSS DE L'OUEST-DE-L'ÎLE-DE-MONTRÉAL,HÔPITAL GÉNÉRAL DU LAKESHORE,51228278,28457,5791,1740,13.13758424,26842,1.8060606719,16457,1335,277,5.5416477622,14878,2.248567049,12000,4194,1533,23.554778125,11964,1.2557756603,4456,1463
2020-2021,12,06,Montréal,CIUSSS DU CENTRE-OUEST-DE-L'ÎLE-DE-MONTRÉAL,HÔPITAL GÉNÉRAL JUIF,51248250,58662,10698,3231,8.4965412779,55517,1.1487803185,22783,1193,382,3.2765587036,19929,1.2539578141,35879,4042,720,11.811206207,35588,1.0898817485,9505,2849
2020-2021,12,06,Montréal,CIUSSS DU CENTRE-SUD-DE-L'ÎLE-DE-MONTRÉAL,HÔPITAL DE VERDUN,51218097,28810,4354,2376,10.2816429,26174,1.3690877504,16947,1136,730,3.4754597667,14630,1.7312214248,11863,4074,1085,20.0046797,11544,0.9101466851,3218,1646
2020-2021,12,06,Montréal,CIUSSS DU CENTRE-SUD-DE-L'ÎLE-DE-MONTRÉAL,HÔPITAL NOTRE-DAME,51236313,28468,3681,4442,12.975471241,25316,2.0179192781,16352,794,1699,4.9601841093,13395,2.603580005,12116,4482,1611,23.793065758,11921,1.3598431573,2887,2743
2020-2021,12,06,Montréal,CIUSSS DU NORD-DE-L'ÎLE-DE-MONTRÉAL,HÔPITAL DU SACRÉ-COEUR-DE-MONTRÉAL,12475976,42625,7731,2360,10.952201558,38924,1.6899701983,26298,1989,1053,4.7217887397,22623,2.2654082374,16327,5208,1680,20.987566063,16301,0.8913606186,5742,1307
2020-2021,12,06,Montréal,CIUSSS DU NORD-DE-L'ÎLE-DE-MONTRÉAL,HÔPITAL EN SANTÉ MENTALE ALBERT-PRÉVOST,51848752,2810,99,2806,17.859932582,2783,0.317918613,1128,33,1124,3.4122963455,1101,0.4639850136,1682,767,235,27.548953792,1682,0.2223067776,66,1682
2020-2021,12,06,Montréal,CIUSSS DU NORD-DE-L'ÎLE-DE-MONTRÉAL,HÔPITAL FLEURY,51228492,23541,3533,1192,8.2335390029,19699,2.494254855,17349,1327,609,4.4022330778,13526,2.9226602675,6192,1880,186,18.968249354,6173,1.5555521806,2206,583
2020-2021,12,06,Montréal,CIUSSS DU NORD-DE-L'ÎLE-DE-MONTRÉAL,HÔPITAL JEAN-TALON,51228500,28557,3552,2533,7.8759437266,24719,2.2700506471,20254,927,1127,4.6616778716,16434,2.8433385055,8303,1801,128,15.716692929,8285,1.1328855696,2625,1406
2020-2021,12,06,Montréal,INSTITUT DE CARDIOLOGIE DE MONTRÉAL,INSTITUT DE CARDIOLOGIE DE MONTRÉAL,51248201,14811,3856,498,8.7690269995,14461,1.1963540634,9116,1634,422,3.1952426137,8770,1.3360543203,5695,1560,174,17.690996878,5691,0.9810718191,2222,76
2020-2021,12,07,Outaouais,CISSS DE L'OUTAOUAIS,CENTRE MULTISERVICES DE SANTÉ ET DE SERVICES SOCIAUX DE MANSFIELD-ET-PONTEFRACT,51245058,6754,760,242,4.3166500099,5750,1.5718482126,6506,706,233,4.1434247874,5503,1.5764248289,248,11,1,8.8610181452,247,1.4698841655,54,9
2020-2021,12,07,Outaouais,CISSS DE L'OUTAOUAIS,CLSC ET CENTRE D'HÉBERGEMENT DE LA PETITE-NATION,51219491,6853,871,271,2.4779296172,5836,0.8640431517,6102,675,241,2.2533242744,5088,0.9062513103,751,3,0,4.302885412,748,0.5769373886,196,30
2020-2021,12,07,Outaouais,CISSS DE L'OUTAOUAIS,HÔPITAL DE GATINEAU,51221703,28528,3880,3821,10.605876605,21044,2.6081457634,16406,1169,1033,3.8438591742,9080,2.742887604,12122,3281,1214,19.757638522,11964,2.5058843196,2711,2788
2020-2021,12,07,Outaouais,CISSS DE L'OUTAOUAIS,HÔPITAL DE HULL,51221711,24695,4504,1011,10.807128085,18696,2.2825790276,14244,1098,593,4.0042895839,8373,2.581995999,10451,2894,1048,20.078932851,10323,2.0397214957,3406,418
2020-2021,12,07,Outaouais,CISSS DE L'OUTAOUAIS,HÔPITAL DE MANIWAKI,51221893,10703,1309,598,5.1130650804,8983,2.0334224214,7335,577,301,3.2042712262,5715,2.1816014387,3368,215,82,9.2701324558,3268,1.7742905107,732,297
2020-2021,12,07,Outaouais,CISSS DE L'OUTAOUAIS,HÔPITAL ET CHSLD DE PAPINEAU,51228823,15988,1946,814,7.6113822346,12681,2.9691396578,11175,631,285,3.8222842406,7961,2.9769814652,4813,1000,169,16.409048988,4720,2.9559132533,1315,529
2020-2021,12,07,Outaouais,CISSS DE L'OUTAOUAIS,HÔPITAL ET CHSLD DU PONTIAC,51219459,7396,947,242,4.7583222913,6814,1.7076696263,6467,734,177,4.0509810491,5889,1.7400811305,929,47,0,9.6823005621,925,1.5013222222,213,65
2020-2021,12,07,Outaouais,CISSS DE L'OUTAOUAIS,HÔPITAL ET CHSLD MÉMORIAL DE WAKEFIELD / WAKEFIELD MEMORIAL HOSPITAL,51228799,9872,868,309,5.1620601195,8543,2.0462606813,8352,561,243,3.6865347621,7038,2.1503055634,1520,250,45,13.269683662,1505,1.5597039498,307,66
2020-2021,12,08,Abitibi-Témiscamingue,CISSS DE L'ABITIBI-TÉMISCAMINGUE,CENTRE MULTISERVICES DE SANTÉ ET DE SERVICES SOCIAUX DE LA SARRE,51247559,12781,1576,705,3.8467769649,11969,1.2222145171,10802,956,620,3.1933543171,9994,1.2705333756,1979,58,0,7.413361827,1975,0.9777088608,620,85
2020-2021,12,08,Abitibi-Témiscamingue,CISSS DE L'ABITIBI-TÉMISCAMINGUE,CENTRE MULTISERVICES DE SANTÉ ET DE SERVICES SOCIAUX DE TÉMISCAMING-KIPAWA,51247476,3675,326,216,2.5116254724,3420,0.6770596166,3652,317,214,2.4475595564,3397,0.6767827822,23,3,0,12.684178744,23,0.7179468599,9,2
2020-2021,12,08,Abitibi-Témiscamingue,CISSS DE L'ABITIBI-TÉMISCAMINGUE,CENTRE MULTISERVICES DE SANTÉ ET DE SERVICES SOCIAUX DE VILLE-MARIE,51247542,9307,1293,543,4.2678147273,8381,2.0361804147,8225,969,442,3.6542482945,7304,2.1009680008,1082,25,0,8.9319403368,1077,1.5968038791,324,101
2020-2021,12,08,Abitibi-Témiscamingue,CISSS DE L'ABITIBI-TÉMISCAMINGUE,HÔPITAL D'AMOS,51228906,14205,1467,696,4.1684765145,12509,0.8007926293,10232,528,556,1.9208227185,8542,0.915365254,3973,357,52,9.9570477809,3967,0.5540874716,939,140
2020-2021,12,08,Abitibi-Témiscamingue,CISSS DE L'ABITIBI-TÉMISCAMINGUE,HÔPITAL DE ROUYN-NORANDA,51228922,19672,2496,1302,5.5436675082,15867,2.5764305547,15419,1197,853,4.3213739182,11635,2.9171322876,4253,284,8,9.975020639,4232,1.6397423073,1299,449
2020-2021,12,08,Abitibi-Témiscamingue,CISSS DE L'ABITIBI-TÉMISCAMINGUE,HÔPITAL DE VAL-D'OR,51225589,22444,2416,1842,6.9457443836,18669,3.0643865945,17683,1241,1304,4.9864569549,13924,3.5356836517,4761,830,117,14.222803741,4745,1.6813854935,1175,538
2020-2021,12,09,Côte-Nord,CISSS DE LA CÔTE-NORD,CENTRE MULTISERVICES DE SANTÉ ET DE SERVICES SOCIAUX DE FERMONT,51245108,3539,8,231,6.1631307494,3082,1.4595718869,3403,8,221,6.1888714206,2946,1.474199951,136,1,0,5.5190461601,136,1.1427022059,0,10
2020-2021,12,09,Côte-Nord,CISSS DE LA CÔTE-NORD,CENTRE MULTISERVICES DE SANTÉ ET DE SERVICES SOCIAUX DE FORESTVILLE,51218741,7785,1060,333,2.7246172483,6316,1.264885476,6619,741,266,2.0623199627,5315,1.3401110066,1166,40,4,6.4842619592,1001,0.8654612055,319,67
2020-2021,12,09,Côte-Nord,CISSS DE LA CÔTE-NORD,CENTRE MULTISERVICES DE SANTÉ ET DE SERVICES SOCIAUX DE LA BASSE-CÔTE-NORD,51245140,2640,375,117,3.2914303451,2589,1.1365510064,2237,247,105,3.0847797149,2190,1.1654540842,403,2,0,4.4385208161,399,0.9779100529,128,12
2020-2021,12,09,Côte-Nord,CISSS DE LA CÔTE-NORD,CENTRE MULTISERVICES DE SANTÉ ET DE SERVICES SOCIAUX DE LA MINGANIE,51245116,9104,680,324,2.3964641916,3457,1.6634708161,6856,454,154,1.7616906927,1899,1.82351296,2248,1,1,4.3324104142,1558,1.4684001926,226,170
2020-2021,12,09,Côte-Nord,CISSS DE LA CÔTE-NORD,CENTRE MULTISERVICES DE SANTÉ ET DE SERVICES SOCIAUX DE PORT-CARTIER,51245132,8955,735,413,3.854893914,8142,1.3416929706,7982,496,336,2.3895133843,7173,1.4224463265,973,151,44,15.876134806,969,0.7439181287,239,77
2020-2021,12,09,Côte-Nord,CISSS DE LA CÔTE-NORD,CENTRE MULTISERVICES DE SANTÉ ET DE SERVICES SOCIAUX DES ESCOUMINS,51218733,6705,1080,238,2.8100055514,6182,0.9323267371,5817,706,202,2.1975903482,5296,0.955114919,888,12,0,6.8217389264,886,0.7961120517,374,36
2020-2021,12,09,Côte-Nord,CISSS DE LA CÔTE-NORD,CLSC ET HÔPITAL LE ROYER,51228765,15918,2362,1176,10.48905891,14585,2.5914050966,11346,900,689,4.5130893903,10020,2.9654287536,4572,1442,845,25.319187992,4565,1.7704375076,1462,487
2020-2021,12,09,Côte-Nord,CISSS DE LA CÔTE-NORD,HÔPITAL ET CLSC DE SEPT-ÎLES,51232023,16127,1848,1187,8.7955826667,12937,2.5869278684,10485,655,456,3.5974513591,7413,2.7466386753,5642,1207,529,18.45570439,5524,2.3726019792,1193,731
2020-2021,12,11,Gaspésie-Îles-de-la-Madeleine,CISSS DE LA GASPÉSIE,CENTRE MULTISERVICES DE SANTÉ ET DE SERVICES SOCIAUX DE GRANDE-VALLÉE,51247732,3957,773,86,1.681706259,3038,0.7467924804,3518,612,76,1.2675743794,2661,0.7681810305,439,5,0,5.0004214123,377,0.5958244916,161,10
2020-2021,12,11,Gaspésie-Îles-de-la-Madeleine,CISSS DE LA GASPÉSIE,CLSC ET CENTRE DE SERVICES AMBULATOIRES DE MURDOCHVILLE,51221307,1289,157,89,4.2537626067,1232,1.9403478986,1282,154,89,3.1800797365,1225,1.9459249433,7,2,2,200.89111111,7,0.9643650794,3,0
2020-2021,12,11,Gaspésie-Îles-de-la-Madeleine,CISSS DE LA GASPÉSIE,CLSC ET CENTRE DE SERVICES AMBULATOIRES DE PASPÉBIAC,51220978,8486,1538,347,3.4557744455,7857,1.3675360966,6185,935,279,2.6058190066,5743,1.4561491284,2301,62,9,5.7404221594,2114,1.1268054242,603,68
2020-2021,12,11,Gaspésie-Îles-de-la-Madeleine,CISSS DE LA GASPÉSIE,HÔPITAL DE CHANDLER,51227775,10689,1826,425,4.6254667051,9585,1.2773775575,8599,1007,328,2.8673548927,7506,1.3964248231,2090,207,19,11.858961191,2079,0.8475705467,819,97
2020-2021,12,11,Gaspésie-Îles-de-la-Madeleine,CISSS DE LA GASPÉSIE,HÔPITAL DE GASPÉ,51220903,9589,1614,461,4.0073714094,8901,0.94145689,7463,870,361,2.6870511933,6779,1.0497326302,2126,62,0,8.6421549336,2122,0.5955562101,744,100
2020-2021,12,11,Gaspésie-Îles-de-la-Madeleine,CISSS DE LA GASPÉSIE,HÔPITAL ET CLSC DE SAINTE-ANNE-DES-MONTS,51247799,10227,1565,519,4.4856105027,9365,1.0815799075,7969,795,336,2.0472270674,7125,1.148037076,2258,321,140,13.091225027,2240,0.8701927083,770,183
2020-2021,12,11,Gaspésie-Îles-de-la-Madeleine,CISSS DE LA GASPÉSIE,HÔPITAL ET GROUPE DE MÉDECINE DE FAMILLE UNIVERSITAIRE DE MARIA,51227908,11325,1990,565,8.0980641158,10445,1.852357481,7706,718,240,3.9826910488,6842,2.0934472133,3619,898,264,16.860999969,3603,1.39453457,1272,325
2020-2021,12,11,Gaspésie-Îles-de-la-Madeleine,CISSS DES ÎLES,HÔPITAL DE L'ARCHIPEL,51227783,9947,1133,290,3.4216995632,8516,0.7651048353,8037,664,151,1.813444797,6623,0.8039468938,1910,133,9,10.188999855,1893,0.6292089276,469,139
2020-2021,12,12,Chaudière-Appalaches,CISSS DE CHAUDIÈRE-APPALACHES,CHSLD ET HÔPITAL PAUL-GILBERT,51245199,28,1,1,0.8799702381,17,0.3811601307,28,1,1,0.8799702381,17,0.3811601307,0,0,0,,0,,0,0
2020-2021,12,12,Chaudière-Appalaches,CISSS DE CHAUDIÈRE-APPALACHES,HÔPITAL DE MONTMAGNY,51245223,21969,3496,820,4.132138746,20442,0.8827721521,15927,1494,400,1.9209956189,14404,1.0261275417,6042,263,0,9.9608174262,6038,0.5407895366,2002,420
2020-2021,12,12,Chaudière-Appalaches,CISSS DE CHAUDIÈRE-APPALACHES,HÔPITAL DE SAINT-GEORGES,51228971,29463,5066,1594,5.8429791886,25588,1.3917189915,19238,1606,651,2.8350268854,15384,1.6685679927,10225,839,11,11.502342162,10204,0.9743292391,3460,943
2020-2021,12,12,Chaudière-Appalaches,CISSS DE CHAUDIÈRE-APPALACHES,HÔPITAL DE THETFORD,51245231,24932,4241,872,4.9506779106,21230,0.7952825797,18310,1871,406,2.5945344681,14611,0.8896199021,6622,575,11,11.465475016,6619,0.5870392473,2370,466
2020-2021,12,12,Chaudière-Appalaches,CISSS DE CHAUDIÈRE-APPALACHES,HÔTEL-DIEU DE LÉVIS,51227569,57292,9919,3755,6.5930172479,49951,0.7067093696,37910,2986,1795,2.3700074519,30574,0.8835551176,19382,3770,419,14.852964692,19377,0.4276733011,6933,1960
2020-2021,12,13,Laval,CISSS DE LAVAL,HÔPITAL DE LA CITÉ-DE-LA-SANTÉ,51228757,65505,11382,4778,8.399900313,53466,2.095535548,41136,3059,1437,4.2238381358,29148,2.6514924409,24369,4530,326,15.449286571,24318,1.4291554381,8323,3341
2020-2021,12,14,Lanaudière,CISSS DE LANAUDIÈRE,HÔPITAL DE LANAUDIÈRE ET CENTRE D'HÉBERGEMENT PARPHILIA-FERLAND,51244945,47250,7555,3684,9.1949600882,43130,1.5950985651,27684,1628,2442,4.462143055,23669,1.9639749485,19566,4450,676,15.891439018,19461,1.1464610275,5927,1242
2020-2021,12,14,Lanaudière,CISSS DE LANAUDIÈRE,HÔPITAL PIERRE-LE GARDEUR,51228062,56496,9073,3630,9.7873885614,42405,3.136734557,35333,2762,1169,5.0547906663,21401,4.0935161779,21163,5610,871,17.688767451,21004,2.161868652,6311,2461
2020-2021,12,15,Laurentides,CISSS DES LAURENTIDES,CENTRE MULTISERVICES DE SANTÉ ET DE SERVICES SOCIAUX D'ARGENTEUIL,51245306,13873,1616,675,6.9621705231,12433,2.4411760816,11323,861,425,4.2635537549,9887,2.6714544913,2550,715,128,18.945087255,2546,1.5469252422,755,250
2020-2021,12,15,Laurentides,CISSS DES LAURENTIDES,CENTRE MULTISERVICES DE SANTÉ ET DE SERVICES SOCIAUX DE RIVIÈRE-ROUGE,51217628,9965,1121,634,5.183540252,9269,1.6947113137,7141,480,272,2.7321805225,6484,1.7836171088,2824,310,70,11.382251239,2785,1.4877220227,641,362
2020-2021,12,15,Laurentides,CISSS DES LAURENTIDES,CENTRE MULTISERVICES DE SANTÉ ET DE SERVICES SOCIAUX DE SAINTE-AGATHE,51246874,23200,3512,1528,10.41063841,19486,3.5641748919,14800,1248,428,6.1012796547,11167,4.4689290121,8400,2037,393,18.003318122,8319,2.3496792483,2264,1100
2020-2021,12,15,Laurentides,CISSS DES LAURENTIDES,HÔPITAL DE MONT-LAURIER,51217610,12938,1689,739,6.975708679,11558,2.3356354906,9685,809,402,4.2847149946,8342,2.5132787568,3253,572,151,14.987474383,3216,1.8748456502,880,337
2020-2021,12,15,Laurentides,CISSS DES LAURENTIDES,HÔPITAL DE SAINT-EUSTACHE,51228864,36572,6611,2457,11.036157481,30262,2.2297231034,19620,1421,815,4.8336962708,13337,3.2487133747,16952,4611,965,18.214796517,16925,1.4267527491,5190,1642
2020-2021,12,15,Laurentides,CISSS DES LAURENTIDES,HÔPITAL DE SAINT-JÉRÔME,51228880,40829,6512,4469,14.469533889,32334,2.9750945427,22471,1772,1370,5.8065354234,14076,4.0452942953,18358,6434,2837,25.073425301,18258,2.1500243424,4740,3099
2020-2021,12,16,Montérégie,CISSS DE LA MONTÉRÉGIE-CENTRE,HÔPITAL CHARLES-LE MOYNE,51233799,54325,10061,5221,9.8140197321,38473,2.6774270773,34534,3079,2157,4.1336947404,18696,3.1724793628,19791,6097,1014,19.725815157,19777,2.2094340789,6982,3064
2020-2021,12,16,Montérégie,CISSS DE LA MONTÉRÉGIE-CENTRE,HÔPITAL DU HAUT-RICHELIEU,51229045,46329,7045,3434,9.5350800794,39545,1.863327468,30289,2030,1172,3.8730984112,23554,2.3007315342,16040,4781,1631,20.226835862,15991,1.2190516019,5015,2262
2020-2021,12,16,Montérégie,CISSS DE LA MONTÉRÉGIE-EST,HÔPITAL HONORÉ-MERCIER,51229193,36016,6229,2422,8.6274121995,29557,2.1584571525,26021,2429,1243,3.9230593132,19571,2.5519151778,9995,3496,767,20.874732505,9986,1.3873408884,3800,1179
2020-2021,12,16,Montérégie,CISSS DE LA MONTÉRÉGIE-EST,HÔPITAL PIERRE-BOUCHER,51229011,42767,7883,2820,11.519846624,34449,2.4433314062,20884,2075,828,4.1102168859,12700,2.9829886264,21883,5796,1990,18.591212864,21749,2.1282067247,5808,1992
2020-2021,12,16,Montérégie,CISSS DE LA MONTÉRÉGIE-EST,HÔTEL-DIEU DE SOREL,51229102,25036,4099,1405,7.3387236823,22412,1.59723536,15174,1315,396,3.7601829884,12584,2.0687085011,9862,1570,165,12.844784977,9828,0.9935501741,2784,1009
2020-2021,12,16,Montérégie,CISSS DE LA MONTÉRÉGIE-OUEST,HÔPITAL ANNA-LABERGE,51229151,32565,5663,2032,12.260930959,27442,2.386799138,20475,1496,613,5.5115620676,15356,3.0942036772,12090,4526,1445,23.691313758,12086,1.4879985337,4167,1419
2020-2021,12,16,Montérégie,CISSS DE LA MONTÉRÉGIE-OUEST,HÔPITAL BARRIE MEMORIAL / BARRIE MEMORIAL HOSPITAL,51228005,12746,1255,345,5.3425605201,11308,2.2530661675,10513,658,271,3.238883076,9081,1.8631882502,2233,461,53,15.246707842,2227,3.8428647159,597,74
2020-2021,12,16,Montérégie,CISSS DE LA MONTÉRÉGIE-OUEST,HÔPITAL DU SUROÎT,51229136,29177,5847,2365,13.853398615,26001,1.8794768257,17365,1391,1525,4.330057843,14240,2.5205691128,11812,4316,2413,27.85380604,11761,1.1032542112,4456,840
2021-2022,12,01,Bas-Saint-Laurent,CISSS DU BAS-SAINT-LAURENT,CENTRE HOSPITALIER RÉGIONAL DU GRAND-PORTAGE,51218352,17746,2992,878,5.0102797344,15014,2.0969700132,12617,1142,537,3.1607963902,9912,2.3823343198,5129,89,0,9.5598861593,5102,1.5425735006,1850,341
2021-2022,12,01,Bas-Saint-Laurent,CISSS DU BAS-SAINT-LAURENT,CENTRE MULTISERVICES DE SANTÉ ET DE SERVICES SOCIAUX DE TROIS-PISTOLES,51236156,8479,1247,261,3.2831465975,7649,1.4164332665,7361,811,226,2.624097609,6551,1.5278398548,1118,40,2,7.6223770125,1098,0.7517478749,436,35
2021-2022,12,01,Bas-Saint-Laurent,CISSS DU BAS-SAINT-LAURENT,CLSC DE POHÉNÉGAMOOK,51219418,7497,917,207,1.488489544,6750,0.6376151852,7048,795,192,1.213359779,6306,0.6469140501,449,3,0,5.8072302648,444,0.5055461712,122,15
2021-2022,12,01,Bas-Saint-Laurent,CISSS DU BAS-SAINT-LAURENT,HÔPITAL D'AMQUI,51226892,13032,1971,442,3.8886523131,11720,1.4912156096,7415,692,256,2.9142600584,6279,1.7261586682,5617,20,2,5.1749472336,5441,1.2200876064,1279,186
2021-2022,12,01,Bas-Saint-Laurent,CISSS DU BAS-SAINT-LAURENT,HÔPITAL DE MATANE,51218980,15378,2429,731,4.4386108221,13704,2.3135996181,11712,1239,435,3.8791238568,10094,2.625659963,3666,42,0,6.226038901,3610,1.4410408587,1190,296
2021-2022,12,01,Bas-Saint-Laurent,CISSS DU BAS-SAINT-LAURENT,HÔPITAL DE NOTRE-DAME-DU-LAC,51221877,11413,1799,329,3.4245829804,10228,1.2112905749,8934,978,169,2.1612129381,7766,1.3765560349,2479,44,0,7.9776075703,2462,0.6899861224,821,160
2021-2022,12,01,Bas-Saint-Laurent,CISSS DU BAS-SAINT-LAURENT,HÔPITAL NOTRE-DAME-DE-FATIMA,51221141,12872,2027,455,3.4323232598,12070,1.3041765626,10332,1028,270,2.5517619209,9547,1.4038087008,2540,3,0,7.0141971785,2523,0.9271698155,999,185
2021-2022,12,01,Bas-Saint-Laurent,CISSS DU BAS-SAINT-LAURENT,HÔPITAL RÉGIONAL DE RIMOUSKI,51227882,29117,4912,1656,4.9872144662,23884,2.0393012989,20937,2036,1026,3.6769180027,15750,2.410829612,8180,206,3,8.3409647175,8134,1.3199048234,2876,630
2021-2022,12,02,Saguenay-Lac-Saint-Jean,CIUSSS DU SAGUENAY - LAC-SAINT-JEAN,HÔPITAL D'ALMA,51219400,28195,3975,1119,4.581017241,22439,2.190147412,21267,2007,494,3.1364873983,15634,2.3399873495,6928,315,26,9.0153151864,6805,1.8459008899,1968,625
2021-2022,12,02,Saguenay-Lac-Saint-Jean,CIUSSS DU SAGUENAY - LAC-SAINT-JEAN,HÔPITAL DE CHICOUTIMI,51218394,46893,7017,2966,7.2237618088,41013,2.0241775982,26343,1935,898,3.267991655,20668,2.616104875,20550,2811,296,12.294654907,20345,1.422852803,5082,2068
2021-2022,12,02,Saguenay-Lac-Saint-Jean,CIUSSS DU SAGUENAY - LAC-SAINT-JEAN,HÔPITAL DE DOLBEAU-MISTASSINI,51219384,16466,2509,644,4.2185994204,15010,1.7654229403,13502,1492,305,2.9973331111,12068,1.9014800621,2964,229,50,9.7818712513,2942,1.2073205114,1017,339
2021-2022,12,02,Saguenay-Lac-Saint-Jean,CIUSSS DU SAGUENAY - LAC-SAINT-JEAN,HÔPITAL DE LA BAIE,51221364,14617,1915,499,4.9754024994,13279,2.2397035419,11422,919,297,3.5038256338,10119,2.4819782093,3195,206,15,10.23623222,3160,1.4638879219,996,202
2021-2022,12,02,Saguenay-Lac-Saint-Jean,CIUSSS DU SAGUENAY - LAC-SAINT-JEAN,HÔPITAL ET CENTRE D'HÉBERGEMENT DE ROBERVAL,51228203,20008,2751,1391,5.6384578252,18170,2.1421848896,13465,964,420,3.3297982424,11738,2.3460877539,6543,580,114,10.389504942,6432,1.7700748428,1787,971
2021-2022,12,02,Saguenay-Lac-Saint-Jean,CIUSSS DU SAGUENAY - LAC-SAINT-JEAN,HÔPITAL ET CENTRE DE RÉADAPTATION DE JONQUIÈRE,51224541,22722,3721,1056,7.0598339593,18608,3.371003511,14418,1209,432,4.4858109847,10517,3.7522719829,8304,638,29,11.529037144,8091,2.8754157569,2512,624
2021-2022,12,03,Capitale-Nationale,CHU DE QUÉBEC - UNIVERSITÉ LAVAL,CENTRE HOSPITALIER DE L'UNIVERSITÉ LAVAL,51217594,68656,5274,6471,7.4319641077,56516,1.7202105009,39945,1022,2027,4.3546765344,27889,2.4799533169,28711,2994,648,11.713328467,28627,0.9800537469,4252,4444
2021-2022,12,03,Capitale-Nationale,CHU DE QUÉBEC - UNIVERSITÉ LAVAL,HÔPITAL DE L'ENFANT-JÉSUS,51233914,53876,8570,6615,9.7506580182,48129,1.5546547646,29956,2562,1456,3.9304453013,24230,2.0746328014,23920,5523,1200,17.03954983,23899,1.0274750571,6008,5159
2021-2022,12,03,Capitale-Nationale,CHU DE QUÉBEC - UNIVERSITÉ LAVAL,HÔPITAL DU SAINT-SACREMENT,51217529,30565,6385,875,7.6936034771,25262,1.8918664617,22194,2645,359,3.505296101,16913,2.2495480958,8371,2294,681,18.798046662,8349,1.1672923238,3740,516
2021-2022,12,03,Capitale-Nationale,CHU DE QUÉBEC - UNIVERSITÉ LAVAL,HÔPITAL SAINT-FRANÇOIS D'ASSISE,51217602,36835,7823,1238,9.751688913,30295,1.9423057985,22415,2283,579,4.1184123975,15908,2.6166244098,14420,4154,780,18.508269572,14387,1.1966979256,5540,659
2021-2022,12,03,Capitale-Nationale,CHU DE QUÉBEC - UNIVERSITÉ LAVAL,L'HÔTEL-DIEU DE QUÉBEC,51217586,16440,4199,816,8.7326284976,15026,1.5547752414,8195,1135,338,3.4777543895,6842,1.7571133359,8245,1357,67,13.95563557,8184,1.3856162431,3064,478
2021-2022,12,03,Capitale-Nationale,CIUSSS DE LA CAPITALE-NATIONALE,CENTRE MULTISERVICES DE SANTÉ ET DE SERVICES SOCIAUX CHAUVEAU,51225001,24558,1632,356,3.2628422058,18326,1.8063604533,22336,1391,294,3.1117637073,16123,1.8964538582,2222,0,0,4.7815142764,2203,1.1469977808,241,62
2021-2022,12,03,Capitale-Nationale,CIUSSS DE LA CAPITALE-NATIONALE,CENTRE MULTISERVICES DE SANTÉ ET DE SERVICES SOCIAUX DE BAIE-SAINT-PAUL,51244804,10323,1739,322,3.9387955159,8513,1.5166812848,8002,968,135,2.4680280624,6198,1.7014744003,2321,82,1,9.0094896836,2315,1.0219306455,771,187
2021-2022,12,03,Capitale-Nationale,CIUSSS DE LA CAPITALE-NATIONALE,CENTRE MULTISERVICES DE SANTÉ ET DE SERVICES SOCIAUX DE SAINT-MARC-DES-CARRIÈRES,51247344,13788,1866,339,3.2143203027,11253,1.5515845898,11134,997,211,2.4459067571,8637,1.8069043392,2654,41,0,6.4379512057,2616,0.7086194997,869,128
2021-2022,12,03,Capitale-Nationale,CIUSSS DE LA CAPITALE-NATIONALE,CENTRE MULTISERVICES DE SANTÉ ET DE SERVICES SOCIAUX DE SAINT-RAYMOND,51247302,17349,2085,340,3.8639430707,13766,2.0998320944,13750,1066,208,2.9805829293,10222,2.438805898,3599,85,4,7.2388255225,3544,1.1221260503,1019,132
2021-2022,12,03,Capitale-Nationale,CIUSSS DE LA CAPITALE-NATIONALE,CENTRE MULTISERVICES DE SANTÉ ET DE SERVICES SOCIAUX DE SAINTE-ANNE-DE-BEAUPRÉ,51225357,15188,1593,275,3.4200025056,11312,1.7783592891,13415,1035,206,2.7984692715,9557,1.9018843954,1773,69,4,8.122691922,1755,1.1056929408,558,69
2021-2022,12,03,Capitale-Nationale,CIUSSS DE LA CAPITALE-NATIONALE,HÔPITAL ET CLSC DE LA MALBAIE,51228690,12379,2010,415,5.0763830546,10500,1.7161470635,9928,1156,237,3.1645037884,8053,1.9762318046,2451,310,28,12.820625142,2447,0.8602163647,854,178
2021-2022,12,03,Capitale-Nationale,INSTITUT UNIVERSITAIRE DE CARDIOLOGIE ET DE PNEUMOLOGIE DE QUÉBEC - UNIVERSITÉ LAVAL,INSTITUT UNIVERSITAIRE DE CARDIOLOGIE ET DE PNEUMOLOGIE DE QUÉBEC,51232130,24233,7353,567,7.6600084481,23100,1.7016219336,12388,2405,328,3.8461322337,11275,2.138284676,11845,1000,0,11.648720862,11825,1.2852690862,4948,239
2021-2022,12,04,Mauricie et Centre-du-Québec,CIUSSS DE LA MAURICIE-ET-DU-CENTRE-DU-QUÉBEC,CENTRE MULTISERVICES DE SANTÉ ET DE SERVICES SOCIAUX AVELLIN-DALCOURT,51233583,18266,2570,470,5.472327077,15343,3.2630434979,15247,1391,332,4.6417731539,12339,3.6997612583,3019,111,7,9.6669132531,3004,1.4692151206,1179,138
2021-2022,12,04,Mauricie et Centre-du-Québec,CIUSSS DE LA MAURICIE-ET-DU-CENTRE-DU-QUÉBEC,CENTRE MULTISERVICES DE SANTÉ ET DE SERVICES SOCIAUX CHRIST-ROI,51246338,18473,1852,587,5.1442026501,14776,3.3987483457,15442,872,375,4.0915672804,11806,3.6276439005,3031,226,19,10.50705167,2970,2.488869248,980,212
2021-2022,12,04,Mauricie et Centre-du-Québec,CIUSSS DE LA MAURICIE-ET-DU-CENTRE-DU-QUÉBEC,CENTRE MULTISERVICES DE SANTÉ ET DE SERVICES SOCIAUX DE FORTIERVILLE,51219160,12543,980,235,2.1643506338,10651,1.5086213866,11566,845,210,2.0581289508,9678,1.5650160157,977,0,0,3.4218327078,973,0.9476889917,135,25
2021-2022,12,04,Mauricie et Centre-du-Québec,CIUSSS DE LA MAURICIE-ET-DU-CENTRE-DU-QUÉBEC,CENTRE MULTISERVICES DE SANTÉ ET DE SERVICES SOCIAUX DU HAUT-SAINT-MAURICE,51219731,10039,1517,558,4.9944606313,8823,2.4282372776,7350,734,289,3.6907148526,6181,2.6842045066,2689,78,4,8.5580647494,2642,1.8293979729,783,269
2021-2022,12,04,Mauricie et Centre-du-Québec,CIUSSS DE LA MAURICIE-ET-DU-CENTRE-DU-QUÉBEC,HÔPITAL DU CENTRE-DE-LA-MAURICIE,51220051,31088,5691,2127,6.6999082354,24800,2.4741946685,18508,1473,465,4.0711369558,12328,3.4185323383,12580,933,73,10.567420067,12472,1.5407601917,4218,1662
2021-2022,12,04,Mauricie et Centre-du-Québec,CIUSSS DE LA MAURICIE-ET-DU-CENTRE-DU-QUÉBEC,HÔPITAL SAINTE-CROIX,51228781,36935,5095,2375,7.4688807289,29126,2.9450469035,23180,1469,921,5.2313467668,15677,3.6549567484,13755,1282,17,11.239584999,13449,2.117531353,3626,1454
2021-2022,12,04,Mauricie et Centre-du-Québec,CIUSSS DE LA MAURICIE-ET-DU-CENTRE-DU-QUÉBEC,HÔTEL-DIEU D'ARTHABASKA,51228039,31225,5174,1860,5.9883104706,25241,2.178645909,18218,1501,443,3.5180348953,12473,2.7183548687,13007,880,22,9.4482536113,12768,1.6514067286,3673,1417
2021-2022,12,04,Mauricie et Centre-du-Québec,CIUSSS DE LA MAURICIE-ET-DU-CENTRE-DU-QUÉBEC,PAVILLON SAINTE-MARIE,51220168,53781,11342,3383,10.216291973,40759,3.2971387028,29601,2377,1044,5.3623135855,16866,4.8626917072,24180,5798,478,16.158500999,23893,2.1920193385,8965,2339
2021-2022,12,05,Estrie,CIUSSS DE L'ESTRIE - CENTRE HOSPITALIER UNIVERSITAIRE DE SHERBROOKE,CENTRE DE SANTÉ ET DE SERVICES SOCIAUX DU GRANIT,51223832,12419,1887,444,6.5821420583,10551,3.4395148169,9824,1020,286,4.9882750294,7968,3.7336596386,2595,326,36,12.616111111,2583,2.532141244,867,158
2021-2022,12,05,Estrie,CIUSSS DE L'ESTRIE - CENTRE HOSPITALIER UNIVERSITAIRE DE SHERBROOKE,CENTRE MULTISERVICES DE SANTÉ ET DE SERVICES SOCIAUX DE LA MRC DE COATICOOK,51247617,13177,1084,385,2.9220569511,11433,1.8424979591,10101,556,266,2.3773607399,8438,1.8066587001,3076,33,4,4.7107358944,2995,1.9434701354,528,119
2021-2022,12,05,Estrie,CIUSSS DE L'ESTRIE - CENTRE HOSPITALIER UNIVERSITAIRE DE SHERBROOKE,CENTRE MULTISERVICES DE SANTÉ ET DE SERVICES SOCIAUX DE MEMPHRÉMAGOG,51219046,18881,3734,683,6.4863701899,16053,2.6391969829,12996,1469,342,3.9063593285,10273,2.973928556,5885,815,134,12.183875909,5780,2.0442666282,2265,341
2021-2022,12,05,Estrie,CIUSSS DE L'ESTRIE - CENTRE HOSPITALIER UNIVERSITAIRE DE SHERBROOKE,CENTRE MULTISERVICES DE SANTÉ ET DE SERVICES SOCIAUX DES SOURCES,51247583,14225,1528,452,4.9957566881,11504,3.3082097048,12574,983,365,4.3143515941,9864,3.5339416058,1651,110,20,10.185331281,1640,1.9505149051,545,87
2021-2022,12,05,Estrie,CIUSSS DE L'ESTRIE - CENTRE HOSPITALIER UNIVERSITAIRE DE SHERBROOKE,CHUS - HÔPITAL FLEURIMONT,51216687,41309,5183,1019,8.0203890193,35996,2.2880639516,21990,915,430,5.1997794452,16686,3.5915787686,19319,2063,95,11.230969512,19310,1.1616813395,4268,589
2021-2022,12,05,Estrie,CIUSSS DE L'ESTRIE - CENTRE HOSPITALIER UNIVERSITAIRE DE SHERBROOKE,CHUS - HÔTEL-DIEU DE SHERBROOKE,51216695,42553,7833,5217,9.9195834215,36012,2.4629081973,20127,1683,1128,4.7517132873,13630,3.7009867938,22426,4112,927,14.557669669,22382,1.7089536234,6150,4089
2021-2022,12,05,Estrie,CIUSSS DE L'ESTRIE - CENTRE HOSPITALIER UNIVERSITAIRE DE SHERBROOKE,HÔPITAL BROME-MISSISQUOI-PERKINS,51229185,24220,3660,786,9.2607085512,20066,3.1861577627,16843,1208,409,5.0727962325,12764,3.6678531634,7377,1973,636,18.822455492,7302,2.3441473417,2452,377
2021-2022,12,05,Estrie,CIUSSS DE L'ESTRIE - CENTRE HOSPITALIER UNIVERSITAIRE DE SHERBROOKE,HÔPITAL DE GRANBY,51228120,34213,5329,2295,9.6152767142,27165,3.4452263227,23139,1794,893,5.5843755372,16154,4.3801564972,11074,3120,591,18.037799952,11011,2.0736104804,3535,1402
2021-2022,12,06,Montréal,CENTRE HOSPITALIER DE L'UNIVERSITÉ DE MONTRÉAL,CENTRE HOSPITALIER DE L'UNIVERSITÉ DE MONTRÉAL,51236297,57226,8291,4622,13.468434705,46488,2.8925793275,34799,2453,1789,6.9379562312,24225,4.1485295838,22427,8655,2369,23.601493983,22263,1.5259443297,5838,2833
2021-2022,12,06,Montréal,CENTRE HOSPITALIER UNIVERSITAIRE SAINTE-JUSTINE,CHU SAINTE-JUSTINE,51222800,71758,1,2075,5.1553234212,63157,1.8152230816,49464,1,1036,4.3809400776,41482,2.1041908271,22294,291,0,6.8734582424,21675,1.2621914776,0,1039
2021-2022,12,06,Montréal,CENTRE UNIVERSITAIRE DE SANTÉ MCGILL,HÔPITAL DE LACHINE,51228310,13611,2084,504,8.0064580119,12538,2.1590961256,9917,881,211,3.8021567902,8893,2.1984408773,3694,913,351,19.293424773,3645,2.0631035665,1203,293
2021-2022,12,06,Montréal,CENTRE UNIVERSITAIRE DE SANTÉ MCGILL,HÔPITAL GÉNÉRAL DE MONTRÉAL,51248219,28498,4585,3531,13.770311182,24897,1.7663817818,10167,680,590,5.3889029048,6732,2.5356499224,18331,4384,1522,18.418927076,18165,1.4812888491,3905,2941
2021-2022,12,06,Montréal,CENTRE UNIVERSITAIRE DE SANTÉ MCGILL,HÔPITAL ROYAL VICTORIA,51223295,42946,6577,1049,14.569887462,34339,3.5507475142,27907,1935,528,7.5876944653,19452,4.4175048981,15039,5903,2636,27.526338021,14887,2.4182047163,4642,521
2021-2022,12,06,Montréal,CENTRE UNIVERSITAIRE DE SANTÉ MCGILL,L'HÔPITAL DE MONTRÉAL POUR ENFANTS,51223279,62782,2,2458,6.0415124071,56849,1.9873294214,47925,0,775,5.2291850113,42056,2.3549718101,14857,481,33,8.6618792675,14793,0.9421345118,2,1683
2021-2022,12,06,Montréal,CIUSSS DE L'EST-DE-L'ÎLE-DE-MONTRÉAL,HÔPITAL MAISONNEUVE-ROSEMONT,12934659,58111,10551,4979,12.86900897,43170,3.6000730252,32289,2226,1235,5.6873651846,17722,4.9204298643,25822,8918,2674,21.849262096,25448,2.6805758584,8325,3744
2021-2022,12,06,Montréal,CIUSSS DE L'EST-DE-L'ÎLE-DE-MONTRÉAL,HÔPITAL SANTA CABRINI,51235919,29928,7321,1080,13.287007568,25292,2.8726672466,17635,1704,422,5.4622126138,13033,3.9963619061,12293,4562,1819,24.512116087,12259,1.6780255549,5617,658
2021-2022,12,06,Montréal,CIUSSS DE L'EST-DE-L'ÎLE-DE-MONTRÉAL,INSTITUT UNIVERSITAIRE EN SANTÉ MENTALE DE MONTRÉAL,51235307,4262,142,4254,15.865100826,4143,1.2265799743,1910,32,1904,3.4909256835,1792,1.3898654514,2352,1053,339,25.913857001,2351,1.1021190746,110,2350
2021-2022,12,06,Montréal,CIUSSS DE L'OUEST-DE-L'ÎLE-DE-MONTRÉAL,CENTRE HOSPITALIER DE ST. MARY,51248243,30167,5595,2259,9.6157822934,28436,2.0178053641,19943,1761,720,5.054798523,18220,2.4136312203,10224,2733,357,18.5124665,10216,1.3118590936,3834,1539
2021-2022,12,06,Montréal,CIUSSS DE L'OUEST-DE-L'ÎLE-DE-MONTRÉAL,HÔPITAL DE LASALLE,51224392,22838,3159,755,9.692712864,18824,3.4663494003,16723,1082,290,5.9982742497,12759,4.0940137027,6115,1802,513,19.79608113,6065,2.1459258496,2077,465
2021-2022,12,06,Montréal,CIUSSS DE L'OUEST-DE-L'ÎLE-DE-MONTRÉAL,HÔPITAL DOUGLAS,51235190,5359,102,5131,7.8030312455,4825,2.117837939,2976,45,2754,3.5356420811,2444,2.0890389162,2383,324,24,13.132343102,2381,2.1473989687,57,2377
2021-2022,12,06,Montréal,CIUSSS DE L'OUEST-DE-L'ÎLE-DE-MONTRÉAL,HÔPITAL GÉNÉRAL DU LAKESHORE,51228278,34257,6963,2235,14.557963214,29210,2.706749496,21347,1946,333,7.1321070356,16349,3.4973397116,12910,4961,2357,26.836797594,12861,1.7017452635,5017,1902
2021-2022,12,06,Montréal,CIUSSS DU CENTRE-OUEST-DE-L'ÎLE-DE-MONTRÉAL,HÔPITAL GÉNÉRAL JUIF,51248250,76479,13377,4007,9.2543281634,69587,1.8541106856,30736,1760,524,3.9772516484,24641,2.0955993286,45743,6322,1178,12.800143343,44946,1.7217179999,11617,3483
2021-2022,12,06,Montréal,CIUSSS DU CENTRE-SUD-DE-L'ÎLE-DE-MONTRÉAL,HÔPITAL DE VERDUN,51218097,33793,5426,2653,9.555804662,30507,1.7132080342,22024,1621,976,3.8021871342,18788,2.11497114,11769,4122,717,20.322876837,11719,1.0690980222,3805,1677
2021-2022,12,06,Montréal,CIUSSS DU CENTRE-SUD-DE-L'ÎLE-DE-MONTRÉAL,HÔPITAL NOTRE-DAME,51236313,31917,4283,4505,13.53947152,27204,2.4666427731,20553,1100,2100,5.8727369484,15875,3.2431831146,11364,4636,1784,27.405574622,11329,1.3784992546,3183,2405
2021-2022,12,06,Montréal,CIUSSS DU NORD-DE-L'ÎLE-DE-MONTRÉAL,HÔPITAL DU SACRÉ-COEUR-DE-MONTRÉAL,12475976,53185,9918,2553,11.765433184,45350,2.4111441811,33915,2724,1137,5.6348920094,26124,3.303620649,19270,7097,2307,22.555122023,19226,1.1984605627,7194,1416
2021-2022,12,06,Montréal,CIUSSS DU NORD-DE-L'ÎLE-DE-MONTRÉAL,HÔPITAL EN SANTÉ MENTALE ALBERT-PRÉVOST,51848752,3070,109,3055,20.114037007,3024,0.2643319187,1367,34,1352,3.9585164188,1321,0.4057115821,1703,994,366,33.082091407,1703,0.1546651334,75,1703
2021-2022,12,06,Montréal,CIUSSS DU NORD-DE-L'ÎLE-DE-MONTRÉAL,HÔPITAL FLEURY,51228492,26677,4263,1119,9.1728628073,20413,3.3210079225,19773,1608,574,5.565877712,13532,4.0593847506,6904,2187,207,19.503238863,6881,1.8689347882,2655,545
2021-2022,12,06,Montréal,CIUSSS DU NORD-DE-L'ÎLE-DE-MONTRÉAL,HÔPITAL JEAN-TALON,51228500,34646,4460,2818,7.9619108667,27691,3.0258527139,25525,1355,1226,5.3024847644,18590,3.868043004,9121,1865,102,15.404280263,9101,1.3055673064,3105,1592
2021-2022,12,06,Montréal,INSTITUT DE CARDIOLOGIE DE MONTRÉAL,INSTITUT DE CARDIOLOGIE DE MONTRÉAL,51248201,16616,4332,501,9.4136568334,16169,1.4557835295,10263,1707,417,3.5565141501,9819,1.6652744962,6353,1974,215,18.875620529,6350,1.1318478128,2625,84
2021-2022,12,07,Outaouais,CISSS DE L'OUTAOUAIS,CENTRE MULTISERVICES DE SANTÉ ET DE SERVICES SOCIAUX DE MANSFIELD-ET-PONTEFRACT,51245058,7784,825,264,3.9662426487,7447,1.314510765,7534,782,251,3.8243839041,7197,1.3082779862,250,7,0,8.2412977778,250,1.49394,43,13
2021-2022,12,07,Outaouais,CISSS DE L'OUTAOUAIS,CLSC ET CENTRE D'HÉBERGEMENT DE LA PETITE-NATION,51219491,8459,946,372,2.931807805,7342,1.3602493644,7723,729,342,2.7533189463,6607,1.4257004776,736,3,0,4.8047282609,735,0.7719017385,217,30
2021-2022,12,07,Outaouais,CISSS DE L'OUTAOUAIS,HÔPITAL DE GATINEAU,51221703,27369,3227,3917,10.159012508,18396,2.4302151434,17640,1235,1037,3.5368968569,8790,2.5907183352,9729,2910,1339,22.165808693,9606,2.2833462014,1992,2880
2021-2022,12,07,Outaouais,CISSS DE L'OUTAOUAIS,HÔPITAL DE HULL,51221711,30902,5463,1410,11.396250288,22629,2.6291068246,19072,1583,857,4.8303294096,10956,2.9689784897,11830,3373,1500,21.98164699,11673,2.3101113681,3880,553
2021-2022,12,07,Outaouais,CISSS DE L'OUTAOUAIS,HÔPITAL DE MANIWAKI,51221893,10863,1457,652,7.3308649135,9687,2.2096234644,7454,690,369,3.561518834,6388,2.2700536596,3409,586,319,15.57278503,3299,2.0926097976,767,283
2021-2022,12,07,Outaouais,CISSS DE L'OUTAOUAIS,HÔPITAL ET CHSLD DE PAPINEAU,51228823,18410,2240,928,8.0256705444,13220,2.9295061985,13238,867,341,3.3538482021,8119,3.0330214449,5172,1476,428,19.983440105,5101,2.7647462916,1373,587
2021-2022,12,07,Outaouais,CISSS DE L'OUTAOUAIS,HÔPITAL ET CHSLD DU PONTIAC,51219459,8163,1021,232,4.8237589326,7443,1.9544396301,7223,792,185,4.2360433107,6505,2.0122290973,940,58,1,9.3397907801,938,1.5536715233,229,47
2021-2022,12,07,Outaouais,CISSS DE L'OUTAOUAIS,HÔPITAL ET CHSLD MÉMORIAL DE WAKEFIELD / WAKEFIELD MEMORIAL HOSPITAL,51228799,11673,955,338,5.1045537661,9987,2.2693674555,10153,641,255,3.8517493188,8505,2.3218792867,1520,252,36,13.472792946,1482,1.9680090718,314,83
2021-2022,12,08,Abitibi-Témiscamingue,CISSS DE L'ABITIBI-TÉMISCAMINGUE,CENTRE MULTISERVICES DE SANTÉ ET DE SERVICES SOCIAUX DE LA SARRE,51247559,15750,1814,857,5.0331393298,14052,1.9285112044,13490,1134,732,4.1173307594,11812,2.0270568772,2260,176,52,10.499625,2240,1.408858755,680,125
2021-2022,12,08,Abitibi-Témiscamingue,CISSS DE L'ABITIBI-TÉMISCAMINGUE,CENTRE MULTISERVICES DE SANTÉ ET DE SERVICES SOCIAUX DE TÉMISCAMING-KIPAWA,51247476,4334,433,256,2.4380522227,4144,0.6842854462,4282,410,248,2.3107858477,4092,0.6859489383,52,1,0,12.917948718,52,0.5533814103,23,8
2021-2022,12,08,Abitibi-Témiscamingue,CISSS DE L'ABITIBI-TÉMISCAMINGUE,CENTRE MULTISERVICES DE SANTÉ ET DE SERVICES SOCIAUX DE VILLE-MARIE,51247542,10489,1342,590,5.165513448,9043,2.923387396,9348,966,485,4.4928053832,7915,2.9925241805,1141,58,1,10.676885042,1128,2.4382653664,376,105
2021-2022,12,08,Abitibi-Témiscamingue,CISSS DE L'ABITIBI-TÉMISCAMINGUE,HÔPITAL D'AMOS,51228906,18310,1840,770,4.4439544572,15800,1.2408291139,13746,747,592,2.3961426354,11263,1.4111188059,4564,492,73,10.611619072,4537,0.8180888007,1093,178
2021-2022,12,08,Abitibi-Témiscamingue,CISSS DE L'ABITIBI-TÉMISCAMINGUE,HÔPITAL DE ROUYN-NORANDA,51228922,23606,2704,1499,6.0886764194,17620,3.266067127,18849,1252,950,4.9868515276,12913,3.7367319325,4757,358,19,10.454515684,4707,1.9748636782,1452,549
2021-2022,12,08,Abitibi-Témiscamingue,CISSS DE L'ABITIBI-TÉMISCAMINGUE,HÔPITAL DE VAL-D'OR,51225589,24039,2469,1795,7.8212920439,18382,4.0908409041,19243,1261,1296,5.6124224249,13599,4.8163847832,4796,1171,233,16.683943854,4783,2.0279784306,1208,499
2021-2022,12,09,Côte-Nord,CISSS DE LA CÔTE-NORD,CENTRE MULTISERVICES DE SANTÉ ET DE SERVICES SOCIAUX DE FERMONT,51245108,5174,15,256,8.4092217498,4375,1.4278534603,4973,14,244,8.487448388,4174,1.4430432439,201,7,3,6.4737935323,201,1.1124198452,1,12
2021-2022,12,09,Côte-Nord,CISSS DE LA CÔTE-NORD,CENTRE MULTISERVICES DE SANTÉ ET DE SERVICES SOCIAUX DE FORESTVILLE,51218741,9568,1344,427,3.3861555881,7785,1.842813566,8287,946,334,2.8604302589,6654,1.9530965919,1281,39,5,6.7871593373,1131,1.1939866392,398,93
2021-2022,12,09,Côte-Nord,CISSS DE LA CÔTE-NORD,CENTRE MULTISERVICES DE SANTÉ ET DE SERVICES SOCIAUX DE LA BASSE-CÔTE-NORD,51245140,3258,395,163,3.3575180752,3148,1.2225390018,2670,276,146,3.1900631502,2569,1.2653518446,588,0,0,4.1179001323,579,1.032580119,119,17
2021-2022,12,09,Côte-Nord,CISSS DE LA CÔTE-NORD,CENTRE MULTISERVICES DE SANTÉ ET DE SERVICES SOCIAUX DE LA MINGANIE,51245116,12267,937,370,2.6000880411,6362,2.0337415732,9051,621,177,1.6581188082,3295,2.1757882313,3216,52,2,5.2511339138,3067,1.8811352027,316,193
2021-2022,12,09,Côte-Nord,CISSS DE LA CÔTE-NORD,CENTRE MULTISERVICES DE SANTÉ ET DE SERVICES SOCIAUX DE PORT-CARTIER,51245132,11552,824,620,3.9879515813,10394,1.7997409296,10496,564,519,2.9025093157,9347,1.8928009284,1056,167,41,14.776589857,1047,0.9689560119,260,101
2021-2022,12,09,Côte-Nord,CISSS DE LA CÔTE-NORD,CENTRE MULTISERVICES DE SANTÉ ET DE SERVICES SOCIAUX DES ESCOUMINS,51218733,7756,1084,265,3.3780938771,6926,1.2463089165,6843,748,227,2.6978166659,6018,1.2894776319,913,47,11,8.4768200073,908,0.9601973201,336,38
2021-2022,12,09,Côte-Nord,CISSS DE LA CÔTE-NORD,CLSC ET HÔPITAL LE ROYER,51228765,18671,2779,1482,10.977248198,16489,3.4666623203,13590,1118,937,5.5410951067,11418,3.9778183083,5081,1641,873,25.517165639,5071,2.3157297487,1661,545
2021-2022,12,09,Côte-Nord,CISSS DE LA CÔTE-NORD,HÔPITAL ET CLSC DE SEPT-ÎLES,51232023,18482,2215,1390,10.774633998,14781,3.0977133745,11971,802,543,4.2744240015,8431,3.2964562,6511,1667,846,22.725795705,6350,2.8338392388,1413,847
2021-2022,12,11,Gaspésie-Îles-de-la-Madeleine,CISSS DE LA GASPÉSIE,CENTRE MULTISERVICES DE SANTÉ ET DE SERVICES SOCIAUX DE GRANDE-VALLÉE,51247732,5136,835,100,1.6439852133,3803,0.7591684927,4645,657,81,1.2824737472,3406,0.7773448816,491,13,2,5.0639867617,397,0.6032269801,178,19
2021-2022,12,11,Gaspésie-Îles-de-la-Madeleine,CISSS DE LA GASPÉSIE,CLSC ET CENTRE DE SERVICES AMBULATOIRES DE MURDOCHVILLE,51221307,1474,209,85,3.1898692145,1410,1.5511451931,1455,203,84,3.1250460099,1391,1.556284847,19,0,0,8.1539619883,19,1.1748684211,6,1
2021-2022,12,11,Gaspésie-Îles-de-la-Madeleine,CISSS DE LA GASPÉSIE,CLSC ET CENTRE DE SERVICES AMBULATOIRES DE PASPÉBIAC,51220978,10635,1870,427,3.8374039597,9766,1.7411024643,8002,1166,339,2.9673485795,7265,1.8330164028,2633,85,11,6.4816056885,2501,1.4741073571,704,88
2021-2022,12,11,Gaspésie-Îles-de-la-Madeleine,CISSS DE LA GASPÉSIE,HÔPITAL DE CHANDLER,51227775,12657,2121,535,5.2890185931,11306,1.7868488462,10457,1304,423,3.5519223434,9116,1.9330936753,2200,303,28,13.545752904,2190,1.1780963978,817,112
2021-2022,12,11,Gaspésie-Îles-de-la-Madeleine,CISSS DE LA GASPÉSIE,HÔPITAL DE GASPÉ,51220903,12618,1953,574,4.9828997376,11173,1.5320556749,9991,1047,405,3.4586412771,8562,1.749494569,2627,210,1,10.779955801,2611,0.8190293204,906,169
2021-2022,12,11,Gaspésie-Îles-de-la-Madeleine,CISSS DE LA GASPÉSIE,HÔPITAL ET CLSC DE SAINTE-ANNE-DES-MONTS,51247799,12098,1832,532,4.4003957725,10797,1.5428706791,9728,993,392,2.4632452428,8444,1.5920370151,2370,299,99,12.351703938,2353,1.36643186,839,140
2021-2022,12,11,Gaspésie-Îles-de-la-Madeleine,CISSS DE LA GASPÉSIE,HÔPITAL ET GROUPE DE MÉDECINE DE FAMILLE UNIVERSITAIRE DE MARIA,51227908,14366,2497,701,8.6940777414,13049,2.1974284534,10367,1135,332,4.1823561943,9065,2.4675500092,3999,1268,448,20.390256106,3984,1.5828069919,1362,369
2021-2022,12,11,Gaspésie-Îles-de-la-Madeleine,CISSS DES ÎLES,HÔPITAL DE L'ARCHIPEL,51227783,14653,1785,423,3.4653277107,12901,1.1527212576,12284,1203,245,2.3613606679,10545,1.2251217533,2369,125,2,9.1897393415,2356,0.8286706518,582,178
2021-2022,12,12,Chaudière-Appalaches,CISSS DE CHAUDIÈRE-APPALACHES,CHSLD ET HÔPITAL PAUL-GILBERT,51245199,16277,1048,259,2.1794751626,14168,1.2324970199,15105,928,233,2.0858588951,12998,1.2877770512,1172,0,0,3.3860227057,1170,0.6183689459,120,26
2021-2022,12,12,Chaudière-Appalaches,CISSS DE CHAUDIÈRE-APPALACHES,HÔPITAL DE MONTMAGNY,51245223,28391,4142,966,4.2508848461,26150,1.3382847249,21473,1874,457,2.4094658538,19238,1.5607599398,6918,347,2,9.9665237625,6912,0.719074918,2268,509
2021-2022,12,12,Chaudière-Appalaches,CISSS DE CHAUDIÈRE-APPALACHES,HÔPITAL DE SAINT-GEORGES,51228971,35998,6120,1919,6.6414443935,30137,1.9922096961,24463,2065,835,3.5541487257,18636,2.4483249267,11535,1571,93,13.188866493,11501,1.2531293173,4055,1084
2021-2022,12,12,Chaudière-Appalaches,CISSS DE CHAUDIÈRE-APPALACHES,HÔPITAL DE THETFORD,51245231,32263,5010,1025,5.8491339495,28714,1.3466828899,24647,2338,528,3.7512528457,21099,1.5306802587,7616,985,32,12.638324543,7615,0.8368784927,2672,497
2021-2022,12,12,Chaudière-Appalaches,CISSS DE CHAUDIÈRE-APPALACHES,HÔTEL-DIEU DE LÉVIS,51227569,70166,12152,4439,6.9450652302,60633,0.9911936752,48338,4181,2158,2.6683839204,38807,1.2431188818,21828,5257,770,16.415755223,21826,0.5432663643,7971,2281
2021-2022,12,13,Laval,CISSS DE LAVAL,HÔPITAL DE LA CITÉ-DE-LA-SANTÉ,51228757,79852,13075,5164,8.4738107756,62626,2.6918319778,52244,3775,1554,4.7978723979,35095,3.4138615583,27608,4924,380,15.429972925,27531,1.7714285008,9300,3610
2021-2022,12,14,Lanaudière,CISSS DE LANAUDIÈRE,HÔPITAL DE LANAUDIÈRE ET CENTRE D'HÉBERGEMENT PARPHILIA-FERLAND,51244945,58878,9674,4211,9.3198961176,49625,2.2137683627,36954,2569,2957,5.1149509601,27835,2.8495462048,21924,5480,897,16.407541773,21790,1.4016125006,7105,1254
2021-2022,12,14,Lanaudière,CISSS DE LANAUDIÈRE,HÔPITAL PIERRE-LE GARDEUR,51228062,66854,10736,3836,10.520362764,45754,4.2972241346,44916,3503,1343,6.1770626342,23902,5.5788205892,21938,7235,819,19.412862929,21852,2.8953973702,7233,2493
2021-2022,12,15,Laurentides,CISSS DES LAURENTIDES,CENTRE MULTISERVICES DE SANTÉ ET DE SERVICES SOCIAUX D'ARGENTEUIL,51245306,17822,2111,731,8.1254972942,15161,2.9655299966,14585,1122,484,4.9281328991,11935,3.2884576177,3237,1068,354,22.531910548,3226,1.7708179204,989,247
2021-2022,12,15,Laurentides,CISSS DES LAURENTIDES,CENTRE MULTISERVICES DE SANTÉ ET DE SERVICES SOCIAUX DE RIVIÈRE-ROUGE,51217628,12335,1404,717,6.1595349277,11020,2.2643522131,9482,718,355,3.2398916954,8211,2.3914955209,2853,586,174,15.863024983,2809,1.8926990625,686,362
2021-2022,12,15,Laurentides,CISSS DES LAURENTIDES,CENTRE MULTISERVICES DE SANTÉ ET DE SERVICES SOCIAUX DE SAINTE-AGATHE,51246874,26290,4148,1713,12.199728308,20899,3.7627943522,17161,1517,519,6.6364421427,11853,4.7594323753,9129,3090,1000,22.657779999,9046,2.456896664,2631,1194
2021-2022,12,15,Laurentides,CISSS DES LAURENTIDES,HÔPITAL DE MONT-LAURIER,51217610,15078,2039,886,8.7383954732,12369,3.1966691819,11490,987,522,5.8605761048,8837,3.4973990985,3588,908,233,17.954154822,3532,2.4442483799,1052,364
2021-2022,12,15,Laurentides,CISSS DES LAURENTIDES,HÔPITAL DE SAINT-EUSTACHE,51228864,42491,7801,2498,12.054814189,30861,3.1118123288,24819,1972,822,5.8849379508,13263,4.7187722528,17672,5914,1626,20.719943115,17598,1.9007025735,5829,1676
2021-2022,12,15,Laurentides,CISSS DES LAURENTIDES,HÔPITAL DE SAINT-JÉRÔME,51228880,48513,8088,4744,16.119252984,35134,4.3844348779,28462,2380,1438,7.2960646066,15196,6.0486212929,20051,8545,3929,28.64359529,19938,3.1160540593,5708,3306
2021-2022,12,16,Montérégie,CISSS DE LA MONTÉRÉGIE-CENTRE,HÔPITAL CHARLES-LE MOYNE,51233799,67405,11149,5700,9.7637660905,39227,4.473820427,46753,4049,2472,5.4230790953,18587,5.4802097195,20652,6576,785,19.590423997,20640,3.5675337129,7100,3228
2021-2022,12,16,Montérégie,CISSS DE LA MONTÉRÉGIE-CENTRE,HÔPITAL DU HAUT-RICHELIEU,51229045,54570,8030,3493,9.3730638018,41793,2.5879077637,38834,2866,1399,4.7597090966,26125,3.1825316853,15736,4757,1917,20.758105529,15668,1.5964251269,5164,2094
2021-2022,12,16,Montérégie,CISSS DE LA MONTÉRÉGIE-EST,HÔPITAL HONORÉ-MERCIER,51229193,42860,7589,2619,9.318521381,32000,3.1540368056,31615,3091,1350,4.6835355932,20777,3.8020891825,11245,3767,1325,22.349653056,11223,1.9543055184,4498,1269
2021-2022,12,16,Montérégie,CISSS DE LA MONTÉRÉGIE-EST,HÔPITAL PIERRE-BOUCHER,51229011,50122,9157,2986,12.612132619,37342,3.6269796744,24414,2310,861,4.9330629966,11882,4.7622358282,25708,7316,3113,19.904679909,25460,3.0971637427,6847,2125
2021-2022,12,16,Montérégie,CISSS DE LA MONTÉRÉGIE-EST,HÔTEL-DIEU DE SOREL,51229102,28880,4699,1536,8.9897322734,24148,2.4607483021,18829,1799,487,4.8934282814,14183,3.0695150493,10051,2438,588,16.663526708,9965,1.5943018621,2900,1049
2021-2022,12,16,Montérégie,CISSS DE LA MONTÉRÉGIE-OUEST,HÔPITAL ANNA-LABERGE,51229151,35450,6325,2018,14.537831226,27781,2.2415304825,22132,1634,566,7.1767275137,14463,3.1556028026,13318,5652,2146,26.770594955,13318,1.2488718276,4691,1452
2021-2022,12,16,Montérégie,CISSS DE LA MONTÉRÉGIE-OUEST,HÔPITAL BARRIE MEMORIAL / BARRIE MEMORIAL HOSPITAL,51228005,16680,1715,314,6.3210793865,13686,3.6010783526,13944,938,244,4.3571709457,10966,3.0656207571,2736,679,63,16.330121528,2720,5.7598386438,777,70
2021-2022,12,16,Montérégie,CISSS DE LA MONTÉRÉGIE-OUEST,HÔPITAL DU SUROÎT,51229136,31771,6505,2591,15.205705282,26206,2.1115194464,19801,1739,1694,4.5598508633,14317,2.8567983865,11970,4344,2617,32.81627866,11889,1.2140378595,4766,897
2022-2023,12,01,Bas-Saint-Laurent,CISSS DU BAS-SAINT-LAURENT,CENTRE HOSPITALIER RÉGIONAL DU GRAND-PORTAGE,51218352,19789,3457,954,5.2570682366,16487,2.2700468214,14463,1390,569,3.3845713391,11212,2.5216675586,5326,202,6,10.341920401,5275,1.7352275408,2067,385
2022-2023,12,01,Bas-Saint-Laurent,CISSS DU BAS-SAINT-LAURENT,CENTRE MULTISERVICES DE SANTÉ ET DE SERVICES SOCIAUX DE TROIS-PISTOLES,51236156,10240,1364,289,3.2806150174,9226,1.3920279042,8881,897,228,2.4810088016,7891,1.4789488728,1359,66,1,8.506003393,1335,0.878250104,467,61
2022-2023,12,01,Bas-Saint-Laurent,CISSS DU BAS-SAINT-LAURENT,CLSC DE POHÉNÉGAMOOK,51219418,9546,1072,208,1.7002759445,8755,0.8179926074,8981,893,186,1.3891644397,8201,0.8252663971,565,12,0,6.6455722714,554,0.7103168873,179,22
2022-2023,12,01,Bas-Saint-Laurent,CISSS DU BAS-SAINT-LAURENT,HÔPITAL D'AMQUI,51226892,14961,2208,413,4.045762761,13201,1.7238861744,8247,728,236,3.1680287108,6746,1.9515026188,6714,50,2,5.1239088306,6455,1.4860084775,1480,177
2022-2023,12,01,Bas-Saint-Laurent,CISSS DU BAS-SAINT-LAURENT,HÔPITAL DE MATANE,51218980,17398,2783,675,4.829174027,15437,2.6847283403,13035,1318,359,4.215335784,11180,3.0352921884,4363,93,3,6.6630913999,4257,1.7640556078,1465,316
2022-2023,12,01,Bas-Saint-Laurent,CISSS DU BAS-SAINT-LAURENT,HÔPITAL DE NOTRE-DAME-DU-LAC,51221877,12670,2024,327,3.8733673156,11377,1.4645196205,10170,1065,159,2.4046328799,8887,1.6198783804,2500,150,8,9.848179,2490,0.9100323516,959,168
2022-2023,12,01,Bas-Saint-Laurent,CISSS DU BAS-SAINT-LAURENT,HÔPITAL NOTRE-DAME-DE-FATIMA,51221141,15622,2394,409,3.4426948285,14518,1.4131963386,12651,1216,225,2.5403586453,11569,1.5281198317,2971,13,1,7.2849886869,2949,0.9623486304,1178,184
2022-2023,12,01,Bas-Saint-Laurent,CISSS DU BAS-SAINT-LAURENT,HÔPITAL RÉGIONAL DE RIMOUSKI,51227882,30073,5141,1498,5.8253010822,23242,2.5995203009,21516,1978,916,4.209897828,14747,3.0617136254,8557,473,26,9.8871237324,8495,1.7971701001,3163,582
2022-2023,12,02,Saguenay-Lac-Saint-Jean,CIUSSS DU SAGUENAY - LAC-SAINT-JEAN,HÔPITAL D'ALMA,51219400,32201,4458,1152,5.2202638203,25287,2.9197216949,24721,2165,506,3.8599784147,17943,3.1294770167,7480,337,17,9.7159343434,7344,2.407243517,2293,646
2022-2023,12,02,Saguenay-Lac-Saint-Jean,CIUSSS DU SAGUENAY - LAC-SAINT-JEAN,HÔPITAL DE CHICOUTIMI,51218394,50454,7595,3145,7.6983725275,43290,2.5075231,29549,2151,1000,3.883650791,22574,3.3139667809,20905,3185,509,13.090442013,20716,1.6287501877,5444,2145
2022-2023,12,02,Saguenay-Lac-Saint-Jean,CIUSSS DU SAGUENAY - LAC-SAINT-JEAN,HÔPITAL DE DOLBEAU-MISTASSINI,51219384,19675,3000,651,4.4495708175,17647,1.8627446434,16544,1875,347,3.0135162127,14545,2.0006993812,3131,405,96,12.037589783,3102,1.2158872412,1125,304
2022-2023,12,02,Saguenay-Lac-Saint-Jean,CIUSSS DU SAGUENAY - LAC-SAINT-JEAN,HÔPITAL DE LA BAIE,51221364,18448,2103,526,5.1608588405,16793,2.6245979145,14780,948,319,3.9257341753,13166,2.8737052087,3668,193,27,10.137724312,3627,1.7203391232,1155,207
2022-2023,12,02,Saguenay-Lac-Saint-Jean,CIUSSS DU SAGUENAY - LAC-SAINT-JEAN,HÔPITAL ET CENTRE D'HÉBERGEMENT DE ROBERVAL,51228203,22546,2902,1418,5.3715340243,20265,2.1413265345,15830,1176,473,3.2375163192,13639,2.336853488,6716,619,105,10.401537043,6626,1.738852626,1726,945
2022-2023,12,02,Saguenay-Lac-Saint-Jean,CIUSSS DU SAGUENAY - LAC-SAINT-JEAN,HÔPITAL ET CENTRE DE RÉADAPTATION DE JONQUIÈRE,51224541,23916,4061,1163,8.1877789973,18842,4.0608113081,14761,1295,394,5.0291800653,9995,4.4359481963,9155,1165,104,13.280523818,8847,3.6369960941,2766,769
2022-2023,12,03,Capitale-Nationale,CHU DE QUÉBEC - UNIVERSITÉ LAVAL,CENTRE HOSPITALIER DE L'UNIVERSITÉ LAVAL,51217594,69805,5052,6550,8.1954897373,57222,1.9312471602,39632,1004,2180,4.7001741368,27137,2.8586864285,30173,3588,1176,12.786559498,30085,1.0946867671,4048,4370
2022-2023,12,03,Capitale-Nationale,CHU DE QUÉBEC - UNIVERSITÉ LAVAL,HÔPITAL DE L'ENFANT-JÉSUS,51233914,54180,8759,6480,10.865497185,48766,1.6772262209,30499,2707,1690,4.0914772707,25179,2.0875645379,23681,6482,1868,19.589826115,23587,1.2391921986,6052,4790
2022-2023,12,03,Capitale-Nationale,CHU DE QUÉBEC - UNIVERSITÉ LAVAL,HÔPITAL DU SAINT-SACREMENT,51217529,31333,6994,853,8.2082225166,25425,2.0235265487,22327,2760,305,3.6729346133,16453,2.3830447166,9006,2546,790,19.451768266,8972,1.3642362659,4234,548
2022-2023,12,03,Capitale-Nationale,CHU DE QUÉBEC - UNIVERSITÉ LAVAL,HÔPITAL SAINT-FRANÇOIS D'ASSISE,51217602,37645,8702,1212,10.793720023,30718,2.0517601877,22893,2490,580,4.269223671,16007,2.733187477,14752,4935,1302,20.918807808,14711,1.3103009653,6212,632
2022-2023,12,03,Capitale-Nationale,CHU DE QUÉBEC - UNIVERSITÉ LAVAL,L'HÔTEL-DIEU DE QUÉBEC,51217586,18050,4607,947,8.4990741767,16309,1.5855714466,8952,1139,341,3.4021689753,7288,1.8048855043,9098,1408,61,13.514186879,9021,1.4083892214,3468,606
2022-2023,12,03,Capitale-Nationale,CIUSSS DE LA CAPITALE-NATIONALE,CENTRE MULTISERVICES DE SANTÉ ET DE SERVICES SOCIAUX CHAUVEAU,51225001,39771,2517,497,3.314590887,26746,2.0983490989,35890,2093,394,3.1442897356,22939,2.2330310703,3881,0,0,4.8894706404,3807,1.2868256574,424,103
2022-2023,12,03,Capitale-Nationale,CIUSSS DE LA CAPITALE-NATIONALE,CENTRE MULTISERVICES DE SANTÉ ET DE SERVICES SOCIAUX DE BAIE-SAINT-PAUL,51244804,12600,2143,353,4.6668173501,9695,2.0448475159,10073,1273,157,2.9741192076,7185,2.315543648,2527,259,38,11.414165348,2510,1.2699663568,870,196
2022-2023,12,03,Capitale-Nationale,CIUSSS DE LA CAPITALE-NATIONALE,CENTRE MULTISERVICES DE SANTÉ ET DE SERVICES SOCIAUX DE SAINT-MARC-DES-CARRIÈRES,51247344,15740,2067,347,3.2585415255,12819,1.682689064,12515,1019,219,2.4990096107,9670,1.9579256578,3225,56,11,6.2059963824,3149,0.8374880915,1048,128
2022-2023,12,03,Capitale-Nationale,CIUSSS DE LA CAPITALE-NATIONALE,CENTRE MULTISERVICES DE SANTÉ ET DE SERVICES SOCIAUX DE SAINT-RAYMOND,51247302,19209,2373,330,4.2507638491,15242,2.1928341644,15496,1245,195,3.2450595136,11566,2.5245199051,3713,146,16,8.4480152318,3676,1.1492331641,1128,135
2022-2023,12,03,Capitale-Nationale,CIUSSS DE LA CAPITALE-NATIONALE,CENTRE MULTISERVICES DE SANTÉ ET DE SERVICES SOCIAUX DE SAINTE-ANNE-DE-BEAUPRÉ,51225357,17069,1830,262,3.9902098671,12489,2.1519772511,14833,1124,189,3.2302975348,10317,2.3422482042,2236,119,17,9.0312562115,2172,1.2481902241,706,73
2022-2023,12,03,Capitale-Nationale,CIUSSS DE LA CAPITALE-NATIONALE,HÔPITAL ET CLSC DE LA MALBAIE,51228690,13457,2164,426,5.8219910745,11037,1.9351219887,10659,1234,249,3.4820259614,8259,2.2464191253,2798,483,112,14.736104062,2778,1.0096349292,930,177
2022-2023,12,03,Capitale-Nationale,INSTITUT UNIVERSITAIRE DE CARDIOLOGIE ET DE PNEUMOLOGIE DE QUÉBEC - UNIVERSITÉ LAVAL,INSTITUT UNIVERSITAIRE DE CARDIOLOGIE ET DE PNEUMOLOGIE DE QUÉBEC,51232130,25595,8145,582,8.2862299494,24204,1.9464296535,13073,2650,314,4.0029862227,11716,2.4599085771,12522,1460,1,12.757947346,12488,1.4646936615,5495,268
2022-2023,12,04,Mauricie et Centre-du-Québec,CIUSSS DE LA MAURICIE-ET-DU-CENTRE-DU-QUÉBEC,CENTRE MULTISERVICES DE SANTÉ ET DE SERVICES SOCIAUX AVELLIN-DALCOURT,51233583,20151,2693,439,5.6630882669,15742,3.7084400895,17083,1460,301,4.8189107755,12689,4.1550902575,3068,158,26,10.363571998,3053,1.8520549005,1233,138
2022-2023,12,04,Mauricie et Centre-du-Québec,CIUSSS DE LA MAURICIE-ET-DU-CENTRE-DU-QUÉBEC,CENTRE MULTISERVICES DE SANTÉ ET DE SERVICES SOCIAUX CHRIST-ROI,51246338,21384,2124,547,5.9123756859,16017,4.1747702961,18239,1060,372,4.8727162795,12916,4.4642398747,3145,311,60,11.941739092,3101,2.96909823,1064,175
2022-2023,12,04,Mauricie et Centre-du-Québec,CIUSSS DE LA MAURICIE-ET-DU-CENTRE-DU-QUÉBEC,CENTRE MULTISERVICES DE SANTÉ ET DE SERVICES SOCIAUX DE FORTIERVILLE,51219160,13516,1091,250,2.257559148,10356,1.8580710055,12541,937,209,2.1533312956,9391,1.9332917746,975,0,0,3.5981965812,965,1.1260521013,154,41
2022-2023,12,04,Mauricie et Centre-du-Québec,CIUSSS DE LA MAURICIE-ET-DU-CENTRE-DU-QUÉBEC,CENTRE MULTISERVICES DE SANTÉ ET DE SERVICES SOCIAUX DU HAUT-SAINT-MAURICE,51219731,11328,1647,578,6.0256937088,9604,2.9493376602,8494,867,291,4.0844246265,6838,3.1984738065,2834,296,25,11.844021015,2766,2.3334327549,780,287
2022-2023,12,04,Mauricie et Centre-du-Québec,CIUSSS DE LA MAURICIE-ET-DU-CENTRE-DU-QUÉBEC,HÔPITAL DU CENTRE-DE-LA-MAURICIE,51220051,31271,5872,2072,8.1163234751,24784,2.7758201976,19329,1563,444,4.6506389363,12923,3.8410730867,11942,1862,246,13.725787254,11861,1.615187613,4309,1628
2022-2023,12,04,Mauricie et Centre-du-Québec,CIUSSS DE LA MAURICIE-ET-DU-CENTRE-DU-QUÉBEC,HÔPITAL SAINTE-CROIX,51228781,38226,5163,2208,8.7971431966,28271,3.6466195729,23173,1446,619,6.1677441898,13656,4.8600639524,15053,2247,114,12.844911959,14615,2.5127983997,3717,1589
2022-2023,12,04,Mauricie et Centre-du-Québec,CIUSSS DE LA MAURICIE-ET-DU-CENTRE-DU-QUÉBEC,HÔTEL-DIEU D'ARTHABASKA,51228039,33954,5654,1956,6.3690294222,27691,2.1062751536,20369,1715,416,3.631559464,14311,2.6758211438,13585,1319,62,10.473521552,13380,1.497099319,3939,1540
2022-2023,12,04,Mauricie et Centre-du-Québec,CIUSSS DE LA MAURICIE-ET-DU-CENTRE-DU-QUÉBEC,PAVILLON SAINTE-MARIE,51220168,54821,11844,3217,11.171696775,40968,3.5271701219,30347,2481,904,5.6517308594,16778,5.2376288062,24474,6658,1306,18.016283096,24190,2.340808989,9363,2313
2022-2023,12,05,Estrie,CIUSSS DE L'ESTRIE - CENTRE HOSPITALIER UNIVERSITAIRE DE SHERBROOKE,CENTRE DE SANTÉ ET DE SERVICES SOCIAUX DU GRANIT,51223832,13967,2149,407,6.4465753602,11522,3.3482080175,11233,1221,238,4.7617531925,8815,3.6820525304,2734,398,63,13.368889702,2707,2.2610859705,928,169
2022-2023,12,05,Estrie,CIUSSS DE L'ESTRIE - CENTRE HOSPITALIER UNIVERSITAIRE DE SHERBROOKE,CENTRE MULTISERVICES DE SANTÉ ET DE SERVICES SOCIAUX DE LA MRC DE COATICOOK,51247617,17574,1185,454,2.8705829635,14509,2.0467055889,14285,690,342,2.7082736359,11270,2.2021504979,3289,0,0,3.5755354549,3239,1.5058398511,495,112
2022-2023,12,05,Estrie,CIUSSS DE L'ESTRIE - CENTRE HOSPITALIER UNIVERSITAIRE DE SHERBROOKE,CENTRE MULTISERVICES DE SANTÉ ET DE SERVICES SOCIAUX DE MEMPHRÉMAGOG,51219046,21155,4011,729,7.0312428767,17933,2.7250212984,15519,1750,399,4.0316362201,12376,3.0356797206,5636,1090,408,15.290805634,5557,2.0331536301,2261,330
2022-2023,12,05,Estrie,CIUSSS DE L'ESTRIE - CENTRE HOSPITALIER UNIVERSITAIRE DE SHERBROOKE,CENTRE MULTISERVICES DE SANTÉ ET DE SERVICES SOCIAUX DES SOURCES,51247583,17101,1741,499,6.2393740782,13522,4.296421675,15091,1058,371,5.5233943704,11537,4.5955843759,2010,193,28,11.614921227,1985,2.5576609292,683,128
2022-2023,12,05,Estrie,CIUSSS DE L'ESTRIE - CENTRE HOSPITALIER UNIVERSITAIRE DE SHERBROOKE,CHUS - HÔPITAL FLEURIMONT,51216687,43738,5585,947,8.9777881933,36985,2.7916659907,23460,972,372,5.9031976414,16714,4.6427166846,20278,3020,266,12.534839892,20271,1.2654235114,4613,575
2022-2023,12,05,Estrie,CIUSSS DE L'ESTRIE - CENTRE HOSPITALIER UNIVERSITAIRE DE SHERBROOKE,CHUS - HÔTEL-DIEU DE SHERBROOKE,51216695,44435,8345,5403,10.831022467,36709,2.8047763037,22031,1820,1074,5.510303663,14349,4.3968859619,22404,4953,1284,16.063157621,22360,1.7830776685,6525,4329
2022-2023,12,05,Estrie,CIUSSS DE L'ESTRIE - CENTRE HOSPITALIER UNIVERSITAIRE DE SHERBROOKE,HÔPITAL BROME-MISSISQUOI-PERKINS,51229185,25889,3922,846,9.9974964163,20355,3.7936493218,18400,1335,361,5.4357127868,12962,4.3431995663,7489,2243,859,21.205510675,7393,2.8301337977,2587,485
2022-2023,12,05,Estrie,CIUSSS DE L'ESTRIE - CENTRE HOSPITALIER UNIVERSITAIRE DE SHERBROOKE,HÔPITAL DE GRANBY,51228120,35742,5807,2173,11.197383657,26848,4.7243902298,24218,1922,823,7.1886785541,15405,6.1282874247,11524,3759,745,19.621786658,11443,2.8344106538,3885,1350
2022-2023,12,06,Montréal,CENTRE HOSPITALIER DE L'UNIVERSITÉ DE MONTRÉAL,CENTRE HOSPITALIER DE L'UNIVERSITÉ DE MONTRÉAL,51236297,62201,8715,5168,13.806387178,48077,3.0378572394,37192,2281,1944,7.3328656775,23243,4.8102512943,25009,9850,2623,23.433449902,24834,1.3790123084,6434,3224
2022-2023,12,06,Montréal,CENTRE HOSPITALIER UNIVERSITAIRE SAINTE-JUSTINE,CHU SAINTE-JUSTINE,51222800,81806,0,1706,6.1023395696,65841,2.6831075368,55045,0,810,5.4063934003,40220,3.3557771355,26761,646,14,7.5338390236,25621,1.6271467524,0,896
2022-2023,12,06,Montréal,CENTRE UNIVERSITAIRE DE SANTÉ MCGILL,HÔPITAL DE LACHINE,51228310,17768,1778,393,7.2706354901,15914,3.0125645832,14791,863,237,4.4192272516,12960,3.1191962449,2977,890,329,21.437642295,2954,2.5447425337,915,156
2022-2023,12,06,Montréal,CENTRE UNIVERSITAIRE DE SANTÉ MCGILL,HÔPITAL GÉNÉRAL DE MONTRÉAL,51248219,28564,4554,3550,16.906601754,24542,1.7913844294,12266,869,756,6.0070056344,8389,2.6400036092,16298,5073,2561,25.109721523,16153,1.3506572395,3685,2794
2022-2023,12,06,Montréal,CENTRE UNIVERSITAIRE DE SANTÉ MCGILL,HÔPITAL ROYAL VICTORIA,51223295,42495,6668,1082,17.313797009,32586,4.1990094843,27264,1904,495,8.5541592393,17595,5.3439089546,15231,6797,3456,32.993841927,14991,2.8552361417,4764,587
2022-2023,12,06,Montréal,CENTRE UNIVERSITAIRE DE SANTÉ MCGILL,L'HÔPITAL DE MONTRÉAL POUR ENFANTS,51223279,70842,3,2208,7.3837726325,57623,2.561154376,54538,1,687,6.6330164798,41437,3.1300038144,16304,995,64,9.8951035363,16186,1.1048702926,2,1521
2022-2023,12,06,Montréal,CIUSSS DE L'EST-DE-L'ÎLE-DE-MONTRÉAL,HÔPITAL MAISONNEUVE-ROSEMONT,12934659,60160,10704,4310,12.926529366,44157,3.3965850324,36012,2508,1066,5.687182197,20310,4.7171695115,24148,8811,3252,23.722594061,23847,2.2718703611,8196,3244
2022-2023,12,06,Montréal,CIUSSS DE L'EST-DE-L'ÎLE-DE-MONTRÉAL,HÔPITAL SANTA CABRINI,51235919,32159,8052,1134,13.771593014,24846,2.9411893933,19454,2016,463,4.9817377603,12186,4.0939267739,12705,4855,2329,27.230691329,12660,1.8316113744,6036,671
2022-2023,12,06,Montréal,CIUSSS DE L'EST-DE-L'ÎLE-DE-MONTRÉAL,INSTITUT UNIVERSITAIRE EN SANTÉ MENTALE DE MONTRÉAL,51235307,4275,167,4263,18.242960039,4126,1.5620004578,1774,42,1763,3.6751330953,1625,1.746291453,2501,1321,444,28.57615676,2501,1.4422592074,125,2500
2022-2023,12,06,Montréal,CIUSSS DE L'OUEST-DE-L'ÎLE-DE-MONTRÉAL,CENTRE HOSPITALIER DE ST. MARY,51248243,30967,5845,2219,10.965704854,28683,2.3980971404,20647,1810,812,5.6201036874,18382,2.8789036074,10320,3529,855,21.66053308,10301,1.5401042779,4035,1407
2022-2023,12,06,Montréal,CIUSSS DE L'OUEST-DE-L'ÎLE-DE-MONTRÉAL,HÔPITAL DE LASALLE,51224392,24210,3714,746,9.9357939212,19045,3.1881736968,18227,1374,252,5.5183389416,13126,3.7505356206,5983,1989,809,23.393415836,5919,1.9410774624,2340,494
2022-2023,12,06,Montréal,CIUSSS DE L'OUEST-DE-L'ÎLE-DE-MONTRÉAL,HÔPITAL DOUGLAS,51235190,5126,102,4922,10.522550342,4656,2.1064540378,2808,45,2614,3.6299946581,2342,2.112148923,2318,634,120,18.872117367,2314,2.100690243,57,2308
2022-2023,12,06,Montréal,CIUSSS DE L'OUEST-DE-L'ÎLE-DE-MONTRÉAL,HÔPITAL GÉNÉRAL DU LAKESHORE,51228278,34743,7517,2718,15.488114152,28454,2.5860664972,21969,2095,397,6.9903451075,15715,3.3113326793,12774,5130,2694,30.102760164,12739,1.6913684791,5422,2321
2022-2023,12,06,Montréal,CIUSSS DU CENTRE-OUEST-DE-L'ÎLE-DE-MONTRÉAL,HÔPITAL GÉNÉRAL JUIF,51248250,80335,14960,4339,10.400936108,70268,2.2933485568,30549,1837,503,4.0992282526,21712,2.7563326348,49786,7879,1973,14.267703337,48556,2.0863234661,13123,3836
2022-2023,12,06,Montréal,CIUSSS DU CENTRE-SUD-DE-L'ÎLE-DE-MONTRÉAL,HÔPITAL DE VERDUN,51218097,37954,6109,2570,8.82027264,33609,2.0469446428,25302,1752,1004,4.1174467433,20998,2.5578847456,12652,3771,361,18.225181021,12611,1.1962016185,4357,1566
2022-2023,12,06,Montréal,CIUSSS DU CENTRE-SUD-DE-L'ÎLE-DE-MONTRÉAL,HÔPITAL NOTRE-DAME,51236313,33588,4466,4989,13.496188247,28690,2.3115618102,20137,886,1787,5.7720927618,15278,3.2504659932,13451,5313,1746,25.059649014,13412,1.2420286974,3580,3202
2022-2023,12,06,Montréal,CIUSSS DU NORD-DE-L'ÎLE-DE-MONTRÉAL,HÔPITAL DU SACRÉ-COEUR-DE-MONTRÉAL,12475976,58331,10733,2900,12.31181143,47099,3.0016925106,39833,3360,1362,6.5312956385,28653,4.0894583561,18498,7816,2765,24.759388763,18446,1.3120169835,7373,1538
2022-2023,12,06,Montréal,CIUSSS DU NORD-DE-L'ÎLE-DE-MONTRÉAL,HÔPITAL EN SANTÉ MENTALE ALBERT-PRÉVOST,51848752,3234,141,3221,21.38696712,3199,0.3227341009,1439,41,1427,3.9578725581,1404,0.438906893,1795,1151,444,35.359372176,1795,0.2318669143,100,1794
2022-2023,12,06,Montréal,CIUSSS DU NORD-DE-L'ÎLE-DE-MONTRÉAL,HÔPITAL FLEURY,51228492,28645,4620,974,10.188332703,20926,3.8279672019,21154,1707,478,6.0291445406,13467,4.7925363852,7491,2942,418,21.933555823,7459,2.0864665728,2913,496
2022-2023,12,06,Montréal,CIUSSS DU NORD-DE-L'ÎLE-DE-MONTRÉAL,HÔPITAL JEAN-TALON,51228500,37787,4672,2992,8.0973115019,28610,3.3918807527,28081,1326,1216,5.2438222859,18951,4.3122467152,9706,2417,141,16.35290914,9659,1.5861187321,3346,1776
2022-2023,12,06,Montréal,INSTITUT DE CARDIOLOGIE DE MONTRÉAL,INSTITUT DE CARDIOLOGIE DE MONTRÉAL,51248201,17526,4831,537,8.982899787,17025,1.3677198564,10926,1998,461,3.7695716639,10432,1.6006169319,6600,1687,194,17.613327525,6593,0.9992104842,2833,76
2022-2023,12,07,Outaouais,CISSS DE L'OUTAOUAIS,CENTRE MULTISERVICES DE SANTÉ ET DE SERVICES SOCIAUX DE MANSFIELD-ET-PONTEFRACT,51245058,9601,1008,223,4.1071951128,9028,1.5381663221,9319,934,215,3.9619152031,8747,1.5452319843,282,7,1,8.9081294326,281,1.3182255832,74,8
2022-2023,12,07,Outaouais,CISSS DE L'OUTAOUAIS,CLSC ET CENTRE D'HÉBERGEMENT DE LA PETITE-NATION,51219491,10735,1273,348,2.9738144181,8685,1.4438505725,10001,1026,322,2.8302865269,7952,1.5109070045,734,0,0,4.9294308205,733,0.7163843414,247,26
2022-2023,12,07,Outaouais,CISSS DE L'OUTAOUAIS,HÔPITAL DE GATINEAU,51221703,35064,4402,4003,12.169823917,22181,3.8797042263,22887,1641,1122,5.4514714807,10306,4.4277768344,12177,3983,1918,24.797148563,11875,3.4040464327,2761,2881
2022-2023,12,07,Outaouais,CISSS DE L'OUTAOUAIS,HÔPITAL DE HULL,51221711,30838,5238,1081,12.985003801,20581,3.2177171501,20609,1645,698,5.0330746411,10546,3.742705054,10229,3626,2055,29.006248113,10035,2.6659959309,3593,383
2022-2023,12,07,Outaouais,CISSS DE L'OUTAOUAIS,HÔPITAL DE MANIWAKI,51221893,12572,1656,642,6.8463898832,10991,2.5838699845,8373,708,331,3.7646221652,6939,2.6982836944,4199,591,251,12.991577095,4052,2.3879379182,948,311
2022-2023,12,07,Outaouais,CISSS DE L'OUTAOUAIS,HÔPITAL ET CHSLD DE PAPINEAU,51228823,20467,2427,938,9.3524310408,14570,3.3825816175,15499,984,387,3.8221780617,9657,3.5987212788,4968,1772,957,26.605529053,4913,2.9577371825,1443,551
2022-2023,12,07,Outaouais,CISSS DE L'OUTAOUAIS,HÔPITAL ET CHSLD DU PONTIAC,51219459,10016,1089,276,5.8011441416,9076,2.1872176314,7791,652,180,4.1562363625,6868,2.2079342199,2225,277,86,11.560908864,2208,2.1227785326,437,96
2022-2023,12,07,Outaouais,CISSS DE L'OUTAOUAIS,HÔPITAL ET CHSLD MÉMORIAL DE WAKEFIELD / WAKEFIELD MEMORIAL HOSPITAL,51228799,15075,1040,389,5.6454513359,12019,3.0770990839,13070,673,283,4.3900541954,10055,3.1631951213,2005,336,78,13.829012746,1964,2.6363171815,367,106
2022-2023,12,08,Abitibi-Témiscamingue,CISSS DE L'ABITIBI-TÉMISCAMINGUE,CENTRE MULTISERVICES DE SANTÉ ET DE SERVICES SOCIAUX DE LA SARRE,51247559,17261,2078,776,6.3351069849,15298,2.5416445323,14450,1237,606,4.7215887159,12523,2.6860763972,2811,404,182,14.62942893,2775,1.8898534535,841,170
2022-2023,12,08,Abitibi-Témiscamingue,CISSS DE L'ABITIBI-TÉMISCAMINGUE,CENTRE MULTISERVICES DE SANTÉ ET DE SERVICES SOCIAUX DE TÉMISCAMING-KIPAWA,51247476,4550,343,255,2.6869249695,4403,0.9200557701,4471,327,246,2.4954476379,4325,0.9237213873,79,13,0,13.523572433,78,0.7168019943,16,9
2022-2023,12,08,Abitibi-Témiscamingue,CISSS DE L'ABITIBI-TÉMISCAMINGUE,CENTRE MULTISERVICES DE SANTÉ ET DE SERVICES SOCIAUX DE VILLE-MARIE,51247542,10858,1376,615,5.2520628415,9303,2.9079607833,9386,894,474,4.5136235706,7858,2.98877881,1472,72,2,9.9606165082,1445,2.4684673203,482,141
2022-2023,12,08,Abitibi-Témiscamingue,CISSS DE L'ABITIBI-TÉMISCAMINGUE,HÔPITAL D'AMOS,51228906,20962,2038,837,4.5404901727,18765,1.5926815437,16105,826,644,2.8318054952,13946,1.7694579091,4857,450,57,10.206202903,4819,1.0810975652,1212,193
2022-2023,12,08,Abitibi-Témiscamingue,CISSS DE L'ABITIBI-TÉMISCAMINGUE,HÔPITAL DE ROUYN-NORANDA,51228922,25326,2944,1365,7.0727123641,19164,3.8730285083,20558,1431,876,5.9939524489,14452,4.370868661,4768,479,22,11.723959499,4712,2.3461214865,1513,489
2022-2023,12,08,Abitibi-Témiscamingue,CISSS DE L'ABITIBI-TÉMISCAMINGUE,HÔPITAL DE VAL-D'OR,51225589,25883,2580,1734,7.5489124672,20740,4.0606047761,21201,1349,1259,5.6871652019,16065,4.6483468548,4682,1062,206,15.979263551,4675,2.0409092692,1231,475
2022-2023,12,09,Côte-Nord,CISSS DE LA CÔTE-NORD,CENTRE MULTISERVICES DE SANTÉ ET DE SERVICES SOCIAUX DE FERMONT,51245108,5808,41,293,8.7035748584,4713,2.0515642903,5545,37,277,8.8446022443,4450,2.0920725968,263,2,1,5.7302027883,263,1.3661575834,4,16
2022-2023,12,09,Côte-Nord,CISSS DE LA CÔTE-NORD,CENTRE MULTISERVICES DE SANTÉ ET DE SERVICES SOCIAUX DE FORESTVILLE,51218741,10310,1426,429,3.3039221899,8774,1.9105195591,9254,1091,370,2.9049901244,7804,2.0171398571,1056,40,0,6.7998666351,970,1.0527207904,335,59
2022-2023,12,09,Côte-Nord,CISSS DE LA CÔTE-NORD,CENTRE MULTISERVICES DE SANTÉ ET DE SERVICES SOCIAUX DE LA BASSE-CÔTE-NORD,51245140,3369,418,136,3.3406448501,3228,1.2169527055,2690,290,122,3.1007588806,2555,1.243468254,679,0,0,4.2910031091,673,1.116288179,128,14
2022-2023,12,09,Côte-Nord,CISSS DE LA CÔTE-NORD,CENTRE MULTISERVICES DE SANTÉ ET DE SERVICES SOCIAUX DE LA MINGANIE,51245116,12381,1123,352,3.049220019,6694,2.5313557332,8645,743,143,1.8005844097,3104,2.6886362579,3736,92,6,5.9385280603,3590,2.3953672238,380,209
2022-2023,12,09,Côte-Nord,CISSS DE LA CÔTE-NORD,CENTRE MULTISERVICES DE SANTÉ ET DE SERVICES SOCIAUX DE PORT-CARTIER,51245132,12783,930,545,5.3934526541,10622,2.919101681,11561,672,452,4.3452068256,9425,3.1003157383,1222,215,68,15.310613066,1197,1.4922491414,258,93
2022-2023,12,09,Côte-Nord,CISSS DE LA CÔTE-NORD,CENTRE MULTISERVICES DE SANTÉ ET DE SERVICES SOCIAUX DES ESCOUMINS,51218733,9270,1265,315,3.5769692856,8225,1.5861189125,8212,860,273,3.0062607566,7180,1.6596816775,1058,27,1,8.0067031611,1045,1.0806828814,405,42
2022-2023,12,09,Côte-Nord,CISSS DE LA CÔTE-NORD,CLSC ET HÔPITAL LE ROYER,51228765,20712,3035,1340,9.60269688,17814,3.5551766869,15419,1253,826,5.4707792875,12526,4.0989290498,5293,1517,703,21.63935612,5288,2.2671581358,1782,514
2022-2023,12,09,Côte-Nord,CISSS DE LA CÔTE-NORD,HÔPITAL ET CLSC DE SEPT-ÎLES,51232023,20072,2035,1237,9.4980424776,15462,3.8204753949,13910,725,568,5.1416428628,9459,4.1642467785,6162,1494,572,19.332109119,6003,3.278790651,1310,669
2022-2023,12,11,Gaspésie-Îles-de-la-Madeleine,CISSS DE LA GASPÉSIE,CENTRE MULTISERVICES DE SANTÉ ET DE SERVICES SOCIAUX DE GRANDE-VALLÉE,51247732,5917,1070,118,2.0279420408,4707,0.9344701744,5331,837,103,1.591984983,4175,0.9621252162,586,27,4,5.9939609405,532,0.7174404762,233,15
2022-2023,12,11,Gaspésie-Îles-de-la-Madeleine,CISSS DE LA GASPÉSIE,CLSC ET CENTRE DE SERVICES AMBULATOIRES DE MURDOCHVILLE,51221307,1909,191,112,3.0819339678,1859,1.453190933,1861,180,112,3.006269628,1811,1.4775978588,48,3,0,6.0155034722,48,0.532337963,11,0
2022-2023,12,11,Gaspésie-Îles-de-la-Madeleine,CISSS DE LA GASPÉSIE,CLSC ET CENTRE DE SERVICES AMBULATOIRES DE PASPÉBIAC,51220978,12733,2137,442,4.3359512247,11377,2.0705209829,9968,1298,353,3.4593952593,8746,2.2044621986,2765,148,24,7.4959909584,2631,1.6252720765,839,89
2022-2023,12,11,Gaspésie-Îles-de-la-Madeleine,CISSS DE LA GASPÉSIE,HÔPITAL DE CHANDLER,51227775,14826,2335,615,5.9319571474,12809,2.2609567275,12474,1478,469,4.1743776388,10467,2.4543317092,2352,445,81,15.253405612,2342,1.3967142281,857,146
2022-2023,12,11,Gaspésie-Îles-de-la-Madeleine,CISSS DE LA GASPÉSIE,HÔPITAL DE GASPÉ,51220903,13263,2133,595,5.0583774619,11464,1.6988737206,10696,1237,366,3.5853003979,8937,1.9308805776,2567,252,11,11.196294204,2527,0.8783571868,896,229
2022-2023,12,11,Gaspésie-Îles-de-la-Madeleine,CISSS DE LA GASPÉSIE,HÔPITAL ET CLSC DE SAINTE-ANNE-DES-MONTS,51247799,12798,2077,558,5.6268409343,11035,2.2034750289,10069,1124,374,3.3185889308,8359,2.3265713602,2729,465,169,14.143436546,2676,1.8189599942,953,184
2022-2023,12,11,Gaspésie-Îles-de-la-Madeleine,CISSS DE LA GASPÉSIE,HÔPITAL ET GROUPE DE MÉDECINE DE FAMILLE UNIVERSITAIRE DE MARIA,51227908,15329,2604,781,9.1066186821,14135,2.1475701961,11392,1228,395,4.0790395063,10215,2.3873248763,3937,1376,642,23.654289998,3920,1.5228013039,1376,386
2022-2023,12,11,Gaspésie-Îles-de-la-Madeleine,CISSS DES ÎLES,HÔPITAL DE L'ARCHIPEL,51227783,15890,1938,428,4.4537096881,14002,1.849598113,13431,1321,262,3.2839272537,11559,1.9683983861,2459,234,19,10.843033754,2443,1.2874972711,617,166
2022-2023,12,12,Chaudière-Appalaches,CISSS DE CHAUDIÈRE-APPALACHES,CHSLD ET HÔPITAL PAUL-GILBERT,51245199,43033,2981,581,2.607578454,32482,1.9574176296,40910,2770,553,2.5581360982,30361,2.042113951,2123,0,0,3.5603277595,2121,0.745034313,211,28
2022-2023,12,12,Chaudière-Appalaches,CISSS DE CHAUDIÈRE-APPALACHES,HÔPITAL DE MONTMAGNY,51245223,31377,4671,1014,4.4907540378,28641,1.4695961015,24640,2276,546,2.5002816784,21907,1.693352556,6737,748,52,11.770736068,6734,0.7416732254,2395,468
2022-2023,12,12,Chaudière-Appalaches,CISSS DE CHAUDIÈRE-APPALACHES,HÔPITAL DE SAINT-GEORGES,51228971,40462,7138,2036,7.2012988181,33065,2.4716852748,28338,2570,1002,4.1339896958,20986,3.0944985811,12124,2335,196,14.370665851,12079,1.3896122518,4568,1034
2022-2023,12,12,Chaudière-Appalaches,CISSS DE CHAUDIÈRE-APPALACHES,HÔPITAL DE THETFORD,51245231,36206,5479,1113,6.6030895278,32792,1.6791197718,28728,2797,588,4.4768228248,25321,1.8941969665,7478,1478,194,14.771502184,7471,0.9501718869,2682,525
2022-2023,12,12,Chaudière-Appalaches,CISSS DE CHAUDIÈRE-APPALACHES,HÔTEL-DIEU DE LÉVIS,51227569,71167,13216,4632,8.1646804894,64029,1.3386657088,49455,4807,2276,3.2967022546,42321,1.693969096,21712,6456,1673,19.252828224,21708,0.6459812307,8409,2356
2022-2023,12,13,Laval,CISSS DE LAVAL,HÔPITAL DE LA CITÉ-DE-LA-SANTÉ,51228757,85630,14605,5371,9.3653545811,64404,3.099714338,56417,4075,1539,5.4632937176,35300,3.99373209,29213,6733,565,16.901128645,29104,2.015367628,10530,3832
2022-2023,12,14,Lanaudière,CISSS DE LANAUDIÈRE,HÔPITAL DE LANAUDIÈRE ET CENTRE D'HÉBERGEMENT PARPHILIA-FERLAND,51244945,62817,10247,4025,10.257866143,51100,2.4589431289,41254,2848,2833,5.4798738573,29657,3.2447578237,21563,6404,2078,19.399047507,21443,1.3721126293,7399,1192
2022-2023,12,14,Lanaudière,CISSS DE LANAUDIÈRE,HÔPITAL PIERRE-LE GARDEUR,51228062,69882,11628,4035,11.577535775,43878,5.3843017002,47823,3864,1458,6.8980087046,21903,6.9919616668,22059,8322,1486,21.722556994,21975,3.7819091518,7764,2577
2022-2023,12,15,Laurentides,CISSS DES LAURENTIDES,CENTRE MULTISERVICES DE SANTÉ ET DE SERVICES SOCIAUX D'ARGENTEUIL,51245306,18954,2314,641,9.525615965,15013,3.7205401245,15582,1263,398,5.9528839544,11658,4.2398287537,3372,1358,575,26.035197871,3355,1.9161088756,1051,243
2022-2023,12,15,Laurentides,CISSS DES LAURENTIDES,CENTRE MULTISERVICES DE SANTÉ ET DE SERVICES SOCIAUX DE RIVIÈRE-ROUGE,51217628,13587,1339,655,6.2889643695,11750,2.9187676359,10914,732,360,4.0428277136,9129,3.0702648763,2673,511,158,15.460058819,2621,2.3910994531,607,295
2022-2023,12,15,Laurentides,CISSS DES LAURENTIDES,CENTRE MULTISERVICES DE SANTÉ ET DE SERVICES SOCIAUX DE SAINTE-AGATHE,51246874,28060,5005,1582,12.442861398,22363,4.0462233128,18338,1808,478,6.7749570867,12725,5.1161647239,9722,3472,1093,23.133874489,9638,2.6335853739,3197,1104
2022-2023,12,15,Laurentides,CISSS DES LAURENTIDES,HÔPITAL DE MONT-LAURIER,51217610,15779,2097,805,9.7067526459,12775,3.0426146554,12022,963,448,5.8315366966,9061,3.2793247311,3757,1162,429,22.107031098,3714,2.4651160025,1134,357
2022-2023,12,15,Laurentides,CISSS DES LAURENTIDES,HÔPITAL DE SAINT-EUSTACHE,51228864,45577,8222,2601,13.286793351,31899,3.7402265223,27918,2154,780,7.0149977116,14330,5.520095875,17659,6739,2261,23.20219007,17569,2.2884917721,6068,1821
2022-2023,12,15,Laurentides,CISSS DES LAURENTIDES,HÔPITAL DE SAINT-JÉRÔME,51228880,53663,8965,5148,14.975142629,36776,4.9506806296,31410,2605,1423,7.2314710991,14702,6.8944784345,22253,8524,3341,25.905296889,22074,3.6560482418,6360,3725
2022-2023,12,16,Montérégie,CISSS DE LA MONTÉRÉGIE-CENTRE,HÔPITAL CHARLES-LE MOYNE,51233799,71504,11686,5608,9.8322579623,38964,5.1323870966,50943,4392,2379,5.950139017,18417,6.1417274348,20561,6553,697,19.450797208,20547,4.227679791,7294,3229
2022-2023,12,16,Montérégie,CISSS DE LA MONTÉRÉGIE-CENTRE,HÔPITAL DU HAUT-RICHELIEU,51229045,57643,8492,3325,10.294920073,42108,2.9440781905,41321,2966,1211,4.9199794831,25908,3.5339519754,16322,5075,2931,23.902193699,16200,2.0007170782,5526,2114
2022-2023,12,16,Montérégie,CISSS DE LA MONTÉRÉGIE-EST,HÔPITAL HONORÉ-MERCIER,51229193,42075,8023,2475,11.242458606,30953,4.319515834,30319,3166,1248,6.1223947396,19219,5.4499857635,11756,4482,1830,24.447223522,11734,2.4679305627,4857,1227
2022-2023,12,16,Montérégie,CISSS DE LA MONTÉRÉGIE-EST,HÔPITAL PIERRE-BOUCHER,51229011,51469,10063,3193,13.950603977,37574,4.7203048946,25682,2876,945,6.2817409946,12055,6.165497834,25787,7439,3200,21.588240737,25519,4.0376056947,7187,2248
2022-2023,12,16,Montérégie,CISSS DE LA MONTÉRÉGIE-EST,HÔTEL-DIEU DE SOREL,51229102,32733,4920,1546,9.0764799031,27823,2.462666479,22639,1890,498,4.7914875264,17790,2.9435698895,10094,2830,855,18.686935858,10033,1.6099532653,3030,1048
2022-2023,12,16,Montérégie,CISSS DE LA MONTÉRÉGIE-OUEST,HÔPITAL ANNA-LABERGE,51229151,34431,6944,1899,18.621937692,25262,2.2502155191,22648,2228,531,9.0456767338,13481,3.1818159714,11783,6196,3291,37.028384113,11781,1.1841849871,4716,1368
2022-2023,12,16,Montérégie,CISSS DE LA MONTÉRÉGIE-OUEST,HÔPITAL BARRIE MEMORIAL / BARRIE MEMORIAL HOSPITAL,51228005,20063,1935,346,5.8889226714,16031,3.3170273394,16941,1069,263,4.1378908171,12927,3.0043800444,3122,672,63,15.390598085,3104,4.6190864834,866,83
2022-2023,12,16,Montérégie,CISSS DE LA MONTÉRÉGIE-OUEST,HÔPITAL DU SUROÎT,51229136,34676,6745,2525,14.736883796,27435,2.2624168844,22751,1960,1460,4.5091627108,15559,2.9805079411,11925,4848,2884,34.249746052,11876,1.3216305294,4785,1065
2023-2024,12,01,Bas-Saint-Laurent,CISSS DU BAS-SAINT-LAURENT,CENTRE HOSPITALIER RÉGIONAL DU GRAND-PORTAGE,51218352,19211,3634,1055,5.1743827321,16350,2.2201366463,13917,1546,593,3.5036182167,11088,2.4957743106,5294,121,2,9.5665304013,5262,1.639317486,2088,462
2023-2024,12,01,Bas-Saint-Laurent,CISSS DU BAS-SAINT-LAURENT,CENTRE MULTISERVICES DE SANTÉ ET DE SERVICES SOCIAUX DE TROIS-PISTOLES,51236156,10404,1587,272,3.3942150989,9482,1.4429325447,8831,1019,202,2.527014746,7948,1.540986866,1573,48,1,8.2627760119,1534,0.9348909894,568,70
2023-2024,12,01,Bas-Saint-Laurent,CISSS DU BAS-SAINT-LAURENT,CLSC DE POHÉNÉGAMOOK,51219418,9907,1269,319,1.7903161345,9195,0.8990280044,9316,1089,297,1.4828106066,8606,0.9090210318,591,9,0,6.6375606317,589,0.7530178268,180,22
2023-2024,12,01,Bas-Saint-Laurent,CISSS DU BAS-SAINT-LAURENT,HÔPITAL D'AMQUI,51226892,13945,2284,444,4.5454633282,12297,1.9323110199,7542,756,232,3.6022657562,6132,2.2209412372,6403,96,4,5.6564419456,6165,1.6452257817,1528,212
2023-2024,12,01,Bas-Saint-Laurent,CISSS DU BAS-SAINT-LAURENT,HÔPITAL DE MATANE,51218980,15696,2724,667,5.5988804119,13833,2.7294627581,11513,1253,391,4.6240002123,9750,3.1202533903,4183,218,22,8.2820732728,4083,1.7962742537,1471,276
2023-2024,12,01,Bas-Saint-Laurent,CISSS DU BAS-SAINT-LAURENT,HÔPITAL DE NOTRE-DAME-DU-LAC,51221877,11726,2108,332,3.5770858918,10595,1.4028822558,9192,1178,177,2.3415670027,8090,1.574640022,2534,64,0,8.0588892177,2505,0.8481835218,930,155
2023-2024,12,01,Bas-Saint-Laurent,CISSS DU BAS-SAINT-LAURENT,HÔPITAL NOTRE-DAME-DE-FATIMA,51221141,15597,2791,498,4.2093846751,14399,1.7500973254,12242,1434,256,3.0309986113,11069,1.9031595497,3355,82,15,8.5091766849,3330,1.2413148148,1357,242
2023-2024,12,01,Bas-Saint-Laurent,CISSS DU BAS-SAINT-LAURENT,HÔPITAL RÉGIONAL DE RIMOUSKI,51227882,28126,5144,1532,6.4689835719,22536,2.4850093801,20026,2115,884,4.2365965079,14507,2.9204086724,8100,929,162,11.988216084,8029,1.6983189411,3029,648
2023-2024,12,02,Saguenay-Lac-Saint-Jean,CIUSSS DU SAGUENAY - LAC-SAINT-JEAN,HÔPITAL D'ALMA,51219400,31995,4855,1210,4.9808620531,25392,2.9064202964,24419,2558,591,3.8211063107,17957,3.1414700086,7576,173,1,8.7189923956,7435,2.3387286109,2297,619
2023-2024,12,02,Saguenay-Lac-Saint-Jean,CIUSSS DU SAGUENAY - LAC-SAINT-JEAN,HÔPITAL DE CHICOUTIMI,51218394,49965,7979,3285,7.5665482504,43775,2.5266525478,28628,2435,1098,4.0105673544,22627,3.3407541015,21337,2895,238,12.337632334,21148,1.655616239,5544,2187
2023-2024,12,02,Saguenay-Lac-Saint-Jean,CIUSSS DU SAGUENAY - LAC-SAINT-JEAN,HÔPITAL DE DOLBEAU-MISTASSINI,51219384,19130,3177,647,4.2545620172,17352,1.8140844795,15991,2051,365,2.9813901396,14248,1.9502364659,3139,274,52,10.74047839,3104,1.1891187894,1126,282
2023-2024,12,02,Saguenay-Lac-Saint-Jean,CIUSSS DU SAGUENAY - LAC-SAINT-JEAN,HÔPITAL DE LA BAIE,51221364,17094,2197,586,5.4411395974,15536,2.7102779745,13222,978,355,4.1556230567,11695,3.0072075436,3872,146,1,9.830886421,3841,1.8061927594,1219,231
2023-2024,12,02,Saguenay-Lac-Saint-Jean,CIUSSS DU SAGUENAY - LAC-SAINT-JEAN,HÔPITAL ET CENTRE D'HÉBERGEMENT DE ROBERVAL,51228203,21657,3210,1402,5.8249433722,19561,2.1695119399,14647,1290,472,3.3664072279,12692,2.3839020424,7010,725,101,10.961916112,6869,1.7733787063,1920,930
2023-2024,12,02,Saguenay-Lac-Saint-Jean,CIUSSS DU SAGUENAY - LAC-SAINT-JEAN,HÔPITAL ET CENTRE DE RÉADAPTATION DE JONQUIÈRE,51224541,23786,4429,1251,7.9066338276,18839,4.1224410502,14278,1530,482,5.0188198433,9678,4.5244308971,9508,862,26,12.243214398,9161,3.6977649517,2899,769
2023-2024,12,03,Capitale-Nationale,CHU DE QUÉBEC - UNIVERSITÉ LAVAL,CENTRE HOSPITALIER DE L'UNIVERSITÉ LAVAL,51217594,67612,5866,6433,8.4518783442,54913,2.2545778727,37776,1112,2109,4.9663983084,25192,3.4431342843,29836,3496,1156,12.86491943,29721,1.2471382468,4754,4324
2023-2024,12,03,Capitale-Nationale,CHU DE QUÉBEC - UNIVERSITÉ LAVAL,HÔPITAL DE L'ENFANT-JÉSUS,51233914,57490,9735,7038,10.344714709,52010,1.6579849495,32303,3148,1891,4.062579628,26984,2.0486415818,25187,6329,1656,18.401720685,25026,1.2367638767,6587,5147
2023-2024,12,03,Capitale-Nationale,CHU DE QUÉBEC - UNIVERSITÉ LAVAL,HÔPITAL DU SAINT-SACREMENT,51217529,32485,7510,894,7.9577805996,26973,1.9987226424,22773,2902,355,3.6015938099,17303,2.3324827262,9712,2749,552,18.172303021,9670,1.4015095369,4608,539
2023-2024,12,03,Capitale-Nationale,CHU DE QUÉBEC - UNIVERSITÉ LAVAL,HÔPITAL SAINT-FRANÇOIS D'ASSISE,51217602,38421,9649,1243,10.648412652,31403,2.3756758466,22828,2700,596,4.7882851591,15855,3.2267447178,15593,4915,802,19.227582177,15548,1.5078023611,6949,647
2023-2024,12,03,Capitale-Nationale,CHU DE QUÉBEC - UNIVERSITÉ LAVAL,L'HÔTEL-DIEU DE QUÉBEC,51217586,19943,4693,923,7.6973096937,17932,1.6154605671,10316,985,334,3.3408888835,8393,1.8927467665,9627,1132,22,12.365517555,9539,1.3714870823,3708,589
2023-2024,12,03,Capitale-Nationale,CIUSSS DE LA CAPITALE-NATIONALE,CENTRE MULTISERVICES DE SANTÉ ET DE SERVICES SOCIAUX CHAUVEAU,51225001,37897,2590,520,3.0972918921,25780,1.9410737113,33430,2089,408,2.8976041978,21399,2.1126531224,4467,0,0,4.5917086411,4381,1.1029938624,501,112
2023-2024,12,03,Capitale-Nationale,CIUSSS DE LA CAPITALE-NATIONALE,CENTRE MULTISERVICES DE SANTÉ ET DE SERVICES SOCIAUX DE BAIE-SAINT-PAUL,51244804,11476,2059,331,5.3586388744,8836,2.1452236432,9283,1275,142,3.1937478306,6659,2.3651560962,2193,358,75,14.522653265,2177,1.4724950237,784,189
2023-2024,12,03,Capitale-Nationale,CIUSSS DE LA CAPITALE-NATIONALE,CENTRE MULTISERVICES DE SANTÉ ET DE SERVICES SOCIAUX DE SAINT-MARC-DES-CARRIÈRES,51247344,16091,2085,358,3.0467973298,13448,1.562840695,13031,1112,236,2.3317142882,10476,1.7853507753,3060,57,10,6.0919761256,2972,0.7785151226,973,122
2023-2024,12,03,Capitale-Nationale,CIUSSS DE LA CAPITALE-NATIONALE,CENTRE MULTISERVICES DE SANTÉ ET DE SERVICES SOCIAUX DE SAINT-RAYMOND,51247302,18661,2512,362,4.327202886,15277,2.0672117308,15188,1405,229,3.3414599794,11836,2.3493759857,3473,147,20,8.6380186838,3441,1.0966519746,1107,133
2023-2024,12,03,Capitale-Nationale,CIUSSS DE LA CAPITALE-NATIONALE,CENTRE MULTISERVICES DE SANTÉ ET DE SERVICES SOCIAUX DE SAINTE-ANNE-DE-BEAUPRÉ,51225357,14828,1664,179,4.2432208959,11310,2.0848246144,12648,973,124,3.2978381518,9167,2.2690877604,2180,137,14,9.7281754587,2143,1.2966117074,691,55
2023-2024,12,03,Capitale-Nationale,CIUSSS DE LA CAPITALE-NATIONALE,HÔPITAL ET CLSC DE LA MALBAIE,51228690,12786,2298,356,5.6877057589,10563,1.6999810923,10356,1423,200,3.2325725023,8136,1.9388445387,2430,463,131,16.150816872,2427,0.8992423202,875,156
2023-2024,12,03,Capitale-Nationale,INSTITUT UNIVERSITAIRE DE CARDIOLOGIE ET DE PNEUMOLOGIE DE QUÉBEC - UNIVERSITÉ LAVAL,INSTITUT UNIVERSITAIRE DE CARDIOLOGIE ET DE PNEUMOLOGIE DE QUÉBEC,51232130,26810,8833,636,8.3402942517,25172,2.1644163709,14006,3009,366,4.2388176892,12399,2.7900931751,12804,1621,8,12.826804775,12773,1.5570597049,5824,270
2023-2024,12,04,Mauricie et Centre-du-Québec,CIUSSS DE LA MAURICIE-ET-DU-CENTRE-DU-QUÉBEC,CENTRE MULTISERVICES DE SANTÉ ET DE SERVICES SOCIAUX AVELLIN-DALCOURT,51233583,20323,2868,511,4.9562164105,16436,2.9843064682,17209,1571,272,4.0966956889,13360,3.31105331,3114,156,22,9.7062138728,3076,1.5651459327,1297,239
2023-2024,12,04,Mauricie et Centre-du-Québec,CIUSSS DE LA MAURICIE-ET-DU-CENTRE-DU-QUÉBEC,CENTRE MULTISERVICES DE SANTÉ ET DE SERVICES SOCIAUX CHRIST-ROI,51246338,20113,2158,606,5.4201985173,15966,3.5467749175,16387,938,409,4.3483543019,12354,3.8331802115,3726,262,45,10.134184335,3612,2.567192691,1220,197
2023-2024,12,04,Mauricie et Centre-du-Québec,CIUSSS DE LA MAURICIE-ET-DU-CENTRE-DU-QUÉBEC,CENTRE MULTISERVICES DE SANTÉ ET DE SERVICES SOCIAUX DE FORTIERVILLE,51219160,11844,1069,214,2.6680379658,9150,2.1427932605,11010,940,195,2.5812889797,8324,2.2368285813,834,1,0,3.8132494005,826,1.1951540221,129,19
2023-2024,12,04,Mauricie et Centre-du-Québec,CIUSSS DE LA MAURICIE-ET-DU-CENTRE-DU-QUÉBEC,CENTRE MULTISERVICES DE SANTÉ ET DE SERVICES SOCIAUX DU HAUT-SAINT-MAURICE,51219731,11254,1739,581,6.1448483749,9720,2.8787482853,8397,991,277,4.1420125243,6907,3.1200655937,2857,310,10,12.031377124,2813,2.286221215,748,304
2023-2024,12,04,Mauricie et Centre-du-Québec,CIUSSS DE LA MAURICIE-ET-DU-CENTRE-DU-QUÉBEC,HÔPITAL DU CENTRE-DE-LA-MAURICIE,51220051,31789,6265,2071,7.6913129891,25630,2.9747718602,19542,1838,445,5.0159886399,13440,4.2758668155,12247,1266,72,11.96021055,12190,1.5402586364,4427,1626
2023-2024,12,04,Mauricie et Centre-du-Québec,CIUSSS DE LA MAURICIE-ET-DU-CENTRE-DU-QUÉBEC,HÔPITAL SAINTE-CROIX,51228781,37893,5868,2213,8.3140113829,27870,3.5176190049,21922,1568,556,5.6884700428,12445,4.6050597072,15971,1825,48,11.917863193,15425,2.6402640915,4300,1657
2023-2024,12,04,Mauricie et Centre-du-Québec,CIUSSS DE LA MAURICIE-ET-DU-CENTRE-DU-QUÉBEC,HÔTEL-DIEU D'ARTHABASKA,51228039,35045,6328,1876,6.2003432888,29014,2.2605976617,20995,1944,440,3.9919996163,15180,2.9036418533,14050,1010,25,9.5002845987,13834,1.5549875106,4384,1436
2023-2024,12,04,Mauricie et Centre-du-Québec,CIUSSS DE LA MAURICIE-ET-DU-CENTRE-DU-QUÉBEC,PAVILLON SAINTE-MARIE,51220168,54387,12531,3158,10.541323754,41898,3.2524708817,29312,2788,914,5.3735877987,17071,4.8120248602,25075,6076,754,16.582267974,24827,2.1801244053,9743,2244
2023-2024,12,05,Estrie,CIUSSS DE L'ESTRIE - CENTRE HOSPITALIER UNIVERSITAIRE DE SHERBROOKE,CENTRE DE SANTÉ ET DE SERVICES SOCIAUX DU GRANIT,51223832,13732,2166,374,5.6242479043,11617,3.1889014423,11159,1245,231,4.4660790742,9069,3.4377894476,2573,178,4,10.647180658,2548,2.3030437816,921,143
2023-2024,12,05,Estrie,CIUSSS DE L'ESTRIE - CENTRE HOSPITALIER UNIVERSITAIRE DE SHERBROOKE,CENTRE MULTISERVICES DE SANTÉ ET DE SERVICES SOCIAUX DE LA MRC DE COATICOOK,51247617,19166,1501,483,3.0367296109,15325,2.2206743701,15299,960,357,2.8619717338,11513,2.4113110059,3867,0,0,3.7281236531,3812,1.6449137227,541,126
2023-2024,12,05,Estrie,CIUSSS DE L'ESTRIE - CENTRE HOSPITALIER UNIVERSITAIRE DE SHERBROOKE,CENTRE MULTISERVICES DE SANTÉ ET DE SERVICES SOCIAUX DE MEMPHRÉMAGOG,51219046,22398,4338,751,6.638563711,19057,2.8699113916,16530,2009,354,4.2450085703,13274,3.1927002243,5868,939,261,13.38114491,5783,2.1289985494,2329,397
2023-2024,12,05,Estrie,CIUSSS DE L'ESTRIE - CENTRE HOSPITALIER UNIVERSITAIRE DE SHERBROOKE,CENTRE MULTISERVICES DE SANTÉ ET DE SERVICES SOCIAUX DES SOURCES,51247583,16914,1995,561,5.337928639,13918,3.7269588942,14729,1284,401,4.7065433084,11763,3.9973508034,2185,136,6,9.5940725909,2155,2.2510331271,711,160
2023-2024,12,05,Estrie,CIUSSS DE L'ESTRIE - CENTRE HOSPITALIER UNIVERSITAIRE DE SHERBROOKE,CHUS - HÔPITAL FLEURIMONT,51216687,42681,6072,1000,9.3678732926,36043,2.9343751445,22150,1134,363,6.4734063205,15519,5.1229632494,20531,2976,192,12.490587404,20524,1.2794979861,4938,637
2023-2024,12,05,Estrie,CIUSSS DE L'ESTRIE - CENTRE HOSPITALIER UNIVERSITAIRE DE SHERBROOKE,CHUS - HÔTEL-DIEU DE SHERBROOKE,51216695,43027,8855,5102,11.66098535,36315,3.0391555372,21469,2205,1156,6.0243366404,14792,4.7259599784,21558,5046,1352,17.274363732,21523,1.8798742431,6650,3946
2023-2024,12,05,Estrie,CIUSSS DE L'ESTRIE - CENTRE HOSPITALIER UNIVERSITAIRE DE SHERBROOKE,HÔPITAL BROME-MISSISQUOI-PERKINS,51229185,25546,4132,873,9.6279792118,20723,3.9341847089,17689,1368,350,5.5699701949,12960,4.5200437243,7857,2240,586,18.764051695,7763,2.956117874,2764,523
2023-2024,12,05,Estrie,CIUSSS DE L'ESTRIE - CENTRE HOSPITALIER UNIVERSITAIRE DE SHERBROOKE,HÔPITAL DE GRANBY,51228120,34061,5928,2294,11.776096358,26477,4.8099848191,23031,2203,919,7.4217196991,15507,6.1423969999,11030,3903,891,20.868176942,10970,2.9265102806,3725,1375
2023-2024,12,06,Montréal,CENTRE HOSPITALIER DE L'UNIVERSITÉ DE MONTRÉAL,CENTRE HOSPITALIER DE L'UNIVERSITÉ DE MONTRÉAL,51236297,68368,10020,5230,12.895032622,51198,3.1138809133,40307,2705,1637,7.4692516533,23343,5.0892210727,28061,9524,1793,20.688659131,27855,1.4585096931,7315,3593
2023-2024,12,06,Montréal,CENTRE HOSPITALIER UNIVERSITAIRE SAINTE-JUSTINE,CHU SAINTE-JUSTINE,51222800,72602,0,1690,5.2015940179,62612,1.9347552919,46162,0,719,4.3982719613,36972,2.5021694195,26440,420,5,6.6041262712,25640,1.1165635942,0,971
2023-2024,12,06,Montréal,CENTRE UNIVERSITAIRE DE SANTÉ MCGILL,HÔPITAL DE LACHINE,51228310,18646,1667,368,7.3014475103,15548,3.81699111,15826,1043,235,5.2480387408,12761,3.9899556156,2820,635,238,18.825294031,2787,3.0250284057,624,133
2023-2024,12,06,Montréal,CENTRE UNIVERSITAIRE DE SANTÉ MCGILL,HÔPITAL GÉNÉRAL DE MONTRÉAL,51248219,29997,4469,3867,17.045717664,25864,1.696419444,12700,880,817,5.9313208224,8708,2.4581142819,17297,5324,2574,25.20625648,17156,1.3098002642,3589,3050
2023-2024,12,06,Montréal,CENTRE UNIVERSITAIRE DE SANTÉ MCGILL,HÔPITAL ROYAL VICTORIA,51223295,42732,6997,1111,17.829826516,32299,4.3110918553,26074,1960,475,8.7919156802,16025,5.6669855088,16658,7114,3564,31.976451988,16274,2.9759440246,5037,636
2023-2024,12,06,Montréal,CENTRE UNIVERSITAIRE DE SANTÉ MCGILL,L'HÔPITAL DE MONTRÉAL POUR ENFANTS,51223279,64494,6,1964,5.7650625123,60257,1.4915867082,49955,1,588,4.5732693035,45739,1.6983681262,14539,1026,66,9.8599816776,14518,0.8401212671,5,1376
2023-2024,12,06,Montréal,CIUSSS DE L'EST-DE-L'ÎLE-DE-MONTRÉAL,HÔPITAL MAISONNEUVE-ROSEMONT,12934659,59895,10694,3747,11.858682644,45348,3.1618999797,35627,2647,925,5.3206509342,21224,4.4298312969,24268,8334,2283,21.456937783,24124,2.0463895222,8047,2822
2023-2024,12,06,Montréal,CIUSSS DE L'EST-DE-L'ÎLE-DE-MONTRÉAL,HÔPITAL SANTA CABRINI,51235919,32464,8076,1145,13.818707474,25112,3.2131871438,18800,2048,431,6.0618475916,11505,4.7207384471,13664,5170,1929,24.491202043,13607,1.9385213289,6028,714
2023-2024,12,06,Montréal,CIUSSS DE L'EST-DE-L'ÎLE-DE-MONTRÉAL,INSTITUT UNIVERSITAIRE EN SANTÉ MENTALE DE MONTRÉAL,51235307,4544,191,4532,12.980801912,4462,1.486496464,2164,72,2155,3.5829745584,2082,1.4867795389,2380,802,196,21.525717204,2380,1.4862488329,119,2377
2023-2024,12,06,Montréal,CIUSSS DE L'OUEST-DE-L'ÎLE-DE-MONTRÉAL,CENTRE HOSPITALIER DE ST. MARY,51248243,30230,6224,2192,12.191620769,27429,2.5659154241,19639,2031,786,5.8400064922,16861,3.1217861073,10591,3905,1207,23.969484311,10568,1.6790365832,4193,1406
2023-2024,12,06,Montréal,CIUSSS DE L'OUEST-DE-L'ÎLE-DE-MONTRÉAL,HÔPITAL DE LASALLE,51224392,24356,3746,794,10.686712092,19292,3.5063261686,18427,1498,259,6.0734578035,13398,4.1838377619,5929,2073,911,25.024448099,5894,1.9662344946,2248,535
2023-2024,12,06,Montréal,CIUSSS DE L'OUEST-DE-L'ÎLE-DE-MONTRÉAL,HÔPITAL DOUGLAS,51235190,5437,131,5257,14.212243782,5025,2.1266691542,2861,58,2704,3.813668492,2452,2.149383723,2576,1105,301,25.761282566,2573,2.1050227793,73,2553
2023-2024,12,06,Montréal,CIUSSS DE L'OUEST-DE-L'ÎLE-DE-MONTRÉAL,HÔPITAL GÉNÉRAL DU LAKESHORE,51228278,34590,7937,2462,15.537649931,28704,2.5458716555,21422,2244,338,6.8974770874,15592,3.2379364774,13168,5436,2630,29.593678383,13112,1.7229098875,5693,2124
2023-2024,12,06,Montréal,CIUSSS DU CENTRE-OUEST-DE-L'ÎLE-DE-MONTRÉAL,HÔPITAL GÉNÉRAL JUIF,51248250,83046,15898,4541,11.279310108,71189,2.5682792597,29932,1955,467,4.0980270465,19554,3.0734098877,53114,9010,2702,15.326268812,51635,2.376987998,13943,4074
2023-2024,12,06,Montréal,CIUSSS DU CENTRE-SUD-DE-L'ÎLE-DE-MONTRÉAL,HÔPITAL DE VERDUN,51218097,39141,6945,2420,9.8193741856,33724,2.2454900236,25614,2132,913,4.4660852789,20228,2.8634414892,13527,4731,646,19.956074271,13496,1.3192954291,4813,1507
2023-2024,12,06,Montréal,CIUSSS DU CENTRE-SUD-DE-L'ÎLE-DE-MONTRÉAL,HÔPITAL NOTRE-DAME,51236313,35193,5051,5284,13.417013208,29287,2.318307848,20870,1122,2016,5.8924311878,15012,3.2624178435,14323,5478,1655,24.381058922,14275,1.3254546604,3929,3268
2023-2024,12,06,Montréal,CIUSSS DU NORD-DE-L'ÎLE-DE-MONTRÉAL,HÔPITAL DU SACRÉ-COEUR-DE-MONTRÉAL,12475976,59019,11508,2722,12.902802276,45913,3.3015150696,39975,3624,1154,6.9595035995,26909,4.6165091502,19044,8468,3031,25.37829926,19004,1.4395293973,7884,1568
2023-2024,12,06,Montréal,CIUSSS DU NORD-DE-L'ÎLE-DE-MONTRÉAL,HÔPITAL EN SANTÉ MENTALE ALBERT-PRÉVOST,51848752,3115,95,3107,24.074136615,3065,0.3575348922,1346,32,1338,4.1392939987,1296,0.4602844222,1769,1089,536,39.242196627,1769,0.2822588091,63,1769
2023-2024,12,06,Montréal,CIUSSS DU NORD-DE-L'ÎLE-DE-MONTRÉAL,HÔPITAL FLEURY,51228492,27526,4678,886,10.271617996,20366,3.9605831342,19691,1649,389,6.1032219316,12552,5.0638317931,7835,2786,386,20.747672481,7814,2.1883823195,3029,497
2023-2024,12,06,Montréal,CIUSSS DU NORD-DE-L'ÎLE-DE-MONTRÉAL,HÔPITAL JEAN-TALON,51228500,38811,5083,3083,8.0728805407,28515,3.1613164124,28731,1665,1136,5.0892188171,18476,4.0231351182,10080,2458,129,16.577204448,10039,1.5752060021,3418,1947
2023-2024,12,06,Montréal,INSTITUT DE CARDIOLOGIE DE MONTRÉAL,INSTITUT DE CARDIOLOGIE DE MONTRÉAL,51248201,18505,5080,489,8.8594338917,17885,1.5739389308,11772,2319,408,3.9975964152,11156,1.8507933947,6733,1666,136,17.359886999,6729,1.1149422896,2761,81
2023-2024,12,07,Outaouais,CISSS DE L'OUTAOUAIS,CENTRE MULTISERVICES DE SANTÉ ET DE SERVICES SOCIAUX DE MANSFIELD-ET-PONTEFRACT,51245058,8760,937,238,3.9372324962,8236,1.6051244536,8355,867,220,3.820751413,7831,1.6086150485,405,4,0,6.3401941015,405,1.5376310014,70,18
2023-2024,12,07,Outaouais,CISSS DE L'OUTAOUAIS,CLSC ET CENTRE D'HÉBERGEMENT DE LA PETITE-NATION,51219491,9927,1249,378,2.9899087505,8234,1.4462271274,9130,1002,347,2.833182305,7439,1.5303385312,797,5,0,4.7852819601,795,0.6591771488,247,31
2023-2024,12,07,Outaouais,CISSS DE L'OUTAOUAIS,HÔPITAL DE GATINEAU,51221703,35485,4645,4042,13.12825993,22097,5.286802042,22517,1623,1086,6.7891440541,9672,6.0084935323,12968,4393,1796,24.135190233,12425,4.7250153141,3022,2956
2023-2024,12,07,Outaouais,CISSS DE L'OUTAOUAIS,HÔPITAL DE HULL,51221711,31479,6062,957,13.955703988,20944,4.5149385929,20281,1957,576,6.9732022583,10041,5.2169723301,11198,4092,1917,26.601901307,10903,3.8684082108,4105,381
2023-2024,12,07,Outaouais,CISSS DE L'OUTAOUAIS,HÔPITAL DE MANIWAKI,51221893,11960,1632,688,7.1259491825,10316,2.4352674379,8463,775,367,3.6158845366,6911,2.5700832409,3497,632,277,15.620566597,3405,2.1616368902,857,321
2023-2024,12,07,Outaouais,CISSS DE L'OUTAOUAIS,HÔPITAL ET CHSLD DE PAPINEAU,51228823,20534,2619,935,9.5600675167,15412,3.7037662211,15073,1073,331,4.349915725,10024,3.9756681187,5461,1824,772,23.940697064,5388,3.1979116143,1546,604
2023-2024,12,07,Outaouais,CISSS DE L'OUTAOUAIS,HÔPITAL ET CHSLD DU PONTIAC,51219459,10459,1238,276,5.5999523005,9597,2.1702352298,7861,751,159,4.3022091478,7008,2.2136400463,2598,236,44,9.5266493457,2589,2.052745483,487,117
2023-2024,12,07,Outaouais,CISSS DE L'OUTAOUAIS,HÔPITAL ET CHSLD MÉMORIAL DE WAKEFIELD / WAKEFIELD MEMORIAL HOSPITAL,51228799,14618,1224,367,5.6955260448,12070,2.756708598,12788,773,257,4.1015295155,10257,2.8865696327,1830,384,131,16.83433895,1813,2.0220231967,451,110
2023-2024,12,08,Abitibi-Témiscamingue,CISSS DE L'ABITIBI-TÉMISCAMINGUE,CENTRE MULTISERVICES DE SANTÉ ET DE SERVICES SOCIAUX DE LA SARRE,51247559,16664,2116,805,6.1880362691,15097,2.385528269,13613,1207,615,4.5384710081,12082,2.5136811648,3051,368,176,13.548092611,3015,1.8719815736,909,190
2023-2024,12,08,Abitibi-Témiscamingue,CISSS DE L'ABITIBI-TÉMISCAMINGUE,CENTRE MULTISERVICES DE SANTÉ ET DE SERVICES SOCIAUX DE TÉMISCAMING-KIPAWA,51247476,4863,399,249,2.8214410972,4601,1.0137782849,4521,318,201,2.2172090123,4262,1.0408129986,342,34,0,10.808965237,339,0.6738905277,81,48
2023-2024,12,08,Abitibi-Témiscamingue,CISSS DE L'ABITIBI-TÉMISCAMINGUE,CENTRE MULTISERVICES DE SANTÉ ET DE SERVICES SOCIAUX DE VILLE-MARIE,51247542,10426,1466,511,4.9843401645,9136,2.78043044,8867,967,363,4.2146790534,7598,2.8591182987,1559,41,2,9.3618803008,1538,2.3916980928,499,148
2023-2024,12,08,Abitibi-Témiscamingue,CISSS DE L'ABITIBI-TÉMISCAMINGUE,HÔPITAL D'AMOS,51228906,21691,2175,947,4.6238355642,19316,1.840689972,16452,900,718,3.119583097,14138,2.056713035,5239,342,27,9.347630485,5178,1.2508610682,1275,229
2023-2024,12,08,Abitibi-Témiscamingue,CISSS DE L'ABITIBI-TÉMISCAMINGUE,HÔPITAL DE ROUYN-NORANDA,51228922,24143,3165,1268,6.9869231937,18877,3.8141107491,19147,1535,810,5.9156292979,13945,4.3548835903,4996,425,11,11.092620596,4932,2.2851007592,1630,458
2023-2024,12,08,Abitibi-Témiscamingue,CISSS DE L'ABITIBI-TÉMISCAMINGUE,HÔPITAL DE VAL-D'OR,51225589,25312,2820,1649,8.2004043207,20568,3.7478268967,20558,1567,1184,6.2535225811,15827,4.271416514,4754,1162,229,16.619418794,4741,1.9999144578,1253,465
2023-2024,12,09,Côte-Nord,CISSS DE LA CÔTE-NORD,CENTRE MULTISERVICES DE SANTÉ ET DE SERVICES SOCIAUX DE FERMONT,51245108,5374,18,331,5.9629030207,4435,2.1599307904,5066,15,314,5.9681167478,4127,2.2291211668,308,3,0,5.8771473665,308,1.2328246753,3,17
2023-2024,12,09,Côte-Nord,CISSS DE LA CÔTE-NORD,CENTRE MULTISERVICES DE SANTÉ ET DE SERVICES SOCIAUX DE FORESTVILLE,51218741,10171,1320,481,3.2775462098,8486,1.8136454814,8963,1009,397,2.7463427114,7395,1.9252470889,1208,52,8,7.2189178624,1091,1.0571891231,311,84
2023-2024,12,09,Côte-Nord,CISSS DE LA CÔTE-NORD,CENTRE MULTISERVICES DE SANTÉ ET DE SERVICES SOCIAUX DE LA BASSE-CÔTE-NORD,51245140,2861,401,90,2.8794956115,2781,0.923937033,2312,278,75,2.619063341,2237,0.9442919585,549,1,0,3.9762522769,544,0.8402348856,123,15
2023-2024,12,09,Côte-Nord,CISSS DE LA CÔTE-NORD,CENTRE MULTISERVICES DE SANTÉ ET DE SERVICES SOCIAUX DE LA MINGANIE,51245116,12826,1332,337,3.0915608053,6538,2.3896847065,9106,897,154,1.6036289565,2937,2.5477583891,3720,142,5,6.7337939815,3601,2.2607587399,435,183
2023-2024,12,09,Côte-Nord,CISSS DE LA CÔTE-NORD,CENTRE MULTISERVICES DE SANTÉ ET DE SERVICES SOCIAUX DE PORT-CARTIER,51245132,12747,1128,641,5.2607830165,10962,2.7593093312,11575,853,578,4.2247810175,9801,2.9064745377,1172,210,57,15.492628697,1161,1.5169611925,275,63
2023-2024,12,09,Côte-Nord,CISSS DE LA CÔTE-NORD,CENTRE MULTISERVICES DE SANTÉ ET DE SERVICES SOCIAUX DES ESCOUMINS,51218733,8502,1202,361,3.7275032999,7637,1.5369686322,7584,855,306,2.9434437632,6736,1.5803046648,918,70,17,10.204962479,901,1.2129824886,347,55
2023-2024,12,09,Côte-Nord,CISSS DE LA CÔTE-NORD,CLSC ET HÔPITAL LE ROYER,51228765,20736,3072,1333,9.4817162985,18170,3.3747763254,15334,1360,735,5.2428501478,12778,3.8835705031,5402,1566,714,21.514069789,5392,2.1690322597,1712,598
2023-2024,12,09,Côte-Nord,CISSS DE LA CÔTE-NORD,HÔPITAL ET CLSC DE SEPT-ÎLES,51232023,19308,2174,1382,9.7583022869,15167,3.920591965,13018,819,596,5.1742993675,9044,4.3151129048,6290,1536,571,19.245512144,6123,3.3378633386,1355,786
2023-2024,12,11,Gaspésie-Îles-de-la-Madeleine,CISSS DE LA GASPÉSIE,CENTRE MULTISERVICES DE SANTÉ ET DE SERVICES SOCIAUX DE GRANDE-VALLÉE,51247732,6068,1096,165,2.0696408299,4723,1.087322441,5624,929,142,1.721382715,4305,1.1099751581,444,21,3,6.4809102853,418,0.8540211324,167,23
2023-2024,12,11,Gaspésie-Îles-de-la-Madeleine,CISSS DE LA GASPÉSIE,CLSC ET CENTRE DE SERVICES AMBULATOIRES DE MURDOCHVILLE,51221307,2012,256,113,3.0159247294,1971,1.3992403743,1975,248,109,2.9816797468,1935,1.4182576802,37,0,0,4.8438663664,36,0.3770601852,8,4
2023-2024,12,11,Gaspésie-Îles-de-la-Madeleine,CISSS DE LA GASPÉSIE,CLSC ET CENTRE DE SERVICES AMBULATOIRES DE PASPÉBIAC,51220978,12005,2143,464,4.4105914202,11210,1.9092018039,9224,1324,368,3.3540356678,8517,2.0003689679,2781,159,26,7.9149676375,2693,1.6208725296,819,96
2023-2024,12,11,Gaspésie-Îles-de-la-Madeleine,CISSS DE LA GASPÉSIE,HÔPITAL DE CHANDLER,51227775,14488,2525,587,6.1437486771,12946,1.9492969729,12261,1637,447,3.7340822527,10728,2.0970240648,2227,640,175,19.410439305,2218,1.2347720669,888,140
2023-2024,12,11,Gaspésie-Îles-de-la-Madeleine,CISSS DE LA GASPÉSIE,HÔPITAL DE GASPÉ,51220903,12984,2085,461,5.6479289467,11117,1.7105883382,10393,1218,282,3.691902723,8586,1.9451062777,2591,369,73,13.493926841,2531,0.9150249133,867,179
2023-2024,12,11,Gaspésie-Îles-de-la-Madeleine,CISSS DE LA GASPÉSIE,HÔPITAL ET CLSC DE SAINTE-ANNE-DES-MONTS,51247799,12495,2107,558,5.3121304299,11137,2.0694213483,9836,1132,387,3.2225526129,8505,2.2196260043,2659,409,91,13.041760896,2632,1.5840525794,975,171
2023-2024,12,11,Gaspésie-Îles-de-la-Madeleine,CISSS DE LA GASPÉSIE,HÔPITAL ET GROUPE DE MÉDECINE DE FAMILLE UNIVERSITAIRE DE MARIA,51227908,15745,2830,763,8.167466268,14461,2.1795217597,11617,1324,366,4.1334265396,10344,2.4394078156,4128,1254,403,19.520043672,4117,1.526555677,1506,397
2023-2024,12,11,Gaspésie-Îles-de-la-Madeleine,CISSS DES ÎLES,HÔPITAL DE L'ARCHIPEL,51227783,15533,2175,476,4.0391516628,13851,1.5217352137,12667,1400,281,2.8855125962,11012,1.5975729003,2866,167,4,9.1379465186,2839,1.2275736762,775,195
2023-2024,12,12,Chaudière-Appalaches,CISSS DE CHAUDIÈRE-APPALACHES,CHSLD ET HÔPITAL PAUL-GILBERT,51245199,41112,3002,528,2.6613175526,31567,2.117165183,40421,2925,519,2.6470891162,30876,2.1485714273,691,0,0,3.4936296028,691,0.7138378357,77,9
2023-2024,12,12,Chaudière-Appalaches,CISSS DE CHAUDIÈRE-APPALACHES,HÔPITAL DE MONTMAGNY,51245223,31069,4773,923,4.3590892762,28598,1.4815342662,24506,2500,520,2.6007495897,22036,1.7167636922,6563,584,59,10.92466483,6562,0.6916050323,2273,403
2023-2024,12,12,Chaudière-Appalaches,CISSS DE CHAUDIÈRE-APPALACHES,HÔPITAL DE SAINT-GEORGES,51228971,41372,7525,2049,6.7353839688,33396,2.6762835869,29627,3013,987,4.2498535026,21699,3.3823012197,11745,1638,100,13.00518483,11697,1.3665565957,4512,1062
2023-2024,12,12,Chaudière-Appalaches,CISSS DE CHAUDIÈRE-APPALACHES,HÔPITAL DE THETFORD,51245231,36238,5854,1097,5.8295004247,33358,1.7079194979,28717,3159,581,4.0310071851,25845,1.9320615099,7521,1054,70,12.696583307,7513,0.9368626233,2695,516
2023-2024,12,12,Chaudière-Appalaches,CISSS DE CHAUDIÈRE-APPALACHES,HÔTEL-DIEU DE LÉVIS,51227569,70897,13688,4704,8.3521700965,63677,1.606871568,48908,5138,2332,3.7142208727,41697,2.0665098608,21989,5892,1618,18.667910723,21980,0.7349180695,8550,2372
2023-2024,12,13,Laval,CISSS DE LAVAL,HÔPITAL DE LA CITÉ-DE-LA-SANTÉ,51228757,83289,16125,5246,10.02408507,65184,2.9930271104,52847,4797,1295,5.472088219,34815,3.8171035872,30442,7504,981,17.92630495,30369,2.0483064236,11328,3951
2023-2024,12,14,Lanaudière,CISSS DE LANAUDIÈRE,HÔPITAL DE LANAUDIÈRE ET CENTRE D'HÉBERGEMENT PARPHILIA-FERLAND,51244945,65623,11526,4527,10.255960338,52947,2.6694509656,42456,3450,3164,5.7210841616,29914,3.5805420725,23167,6618,1763,18.566604917,23033,1.4861756924,8076,1363
2023-2024,12,14,Lanaudière,CISSS DE LANAUDIÈRE,HÔPITAL PIERRE-LE GARDEUR,51228062,68651,12724,3933,11.252881305,45026,5.3321434714,45739,4342,1340,6.6245782593,22232,6.5877030482,22912,8148,1006,20.492317102,22794,4.1075404834,8382,2593
2023-2024,12,15,Laurentides,CISSS DES LAURENTIDES,CENTRE MULTISERVICES DE SANTÉ ET DE SERVICES SOCIAUX D'ARGENTEUIL,51245306,17996,2365,558,9.1149113846,14658,3.5298906551,14838,1303,359,5.826430973,11515,4.0176374053,3158,1204,464,24.565979259,3143,1.7429342984,1062,199
2023-2024,12,15,Laurentides,CISSS DES LAURENTIDES,CENTRE MULTISERVICES DE SANTÉ ET DE SERVICES SOCIAUX DE RIVIÈRE-ROUGE,51217628,12711,1481,755,6.6325881127,11200,2.8318057788,9937,807,403,4.1705251976,8487,3.0017666235,2774,558,151,15.452169651,2713,2.3001221485,674,352
2023-2024,12,15,Laurentides,CISSS DES LAURENTIDES,CENTRE MULTISERVICES DE SANTÉ ET DE SERVICES SOCIAUX DE SAINTE-AGATHE,51246874,28551,5328,1678,11.663547083,22906,3.9050532248,18457,1981,492,6.3084738551,12914,4.9160044869,10094,3441,892,21.455362674,9992,2.5984654946,3347,1186
2023-2024,12,15,Laurentides,CISSS DES LAURENTIDES,HÔPITAL DE MONT-LAURIER,51217610,16198,2295,908,10.17855644,13266,3.6161731955,12011,1132,466,6.4279793523,9135,3.9927508058,4187,1220,420,20.937615768,4131,2.783436214,1163,442
2023-2024,12,15,Laurentides,CISSS DES LAURENTIDES,HÔPITAL DE SAINT-EUSTACHE,51228864,46027,9661,2858,12.984350973,32811,3.9147824832,27598,2592,724,7.4200449711,14492,5.7741091445,18429,6501,1538,21.317072066,18319,2.4438854923,7069,2134
2023-2024,12,15,Laurentides,CISSS DES LAURENTIDES,HÔPITAL DE SAINT-JÉRÔME,51228880,53308,9771,5121,14.638510282,38332,4.5129377326,30418,3016,1333,6.8981720984,15619,6.278540524,22890,8229,3428,24.924469516,22713,3.2987894476,6755,3788
2023-2024,12,16,Montérégie,CISSS DE LA MONTÉRÉGIE-CENTRE,HÔPITAL CHARLES-LE MOYNE,51233799,69453,12889,5372,10.102834151,38372,5.4009649325,48172,5115,2113,5.9294569978,17113,6.3420274223,21281,7135,578,19.549755076,21259,4.6434315401,7774,3259
2023-2024,12,16,Montérégie,CISSS DE LA MONTÉRÉGIE-CENTRE,HÔPITAL DU HAUT-RICHELIEU,51229045,55641,9478,3222,11.147310287,42552,3.6550388022,37578,3095,978,5.9935325634,24727,4.545176831,18063,5657,2643,21.869153795,17825,2.4202313386,6383,2244
2023-2024,12,16,Montérégie,CISSS DE LA MONTÉRÉGIE-EST,HÔPITAL HONORÉ-MERCIER,51229193,42613,8440,2248,9.9121336864,33052,4.4308202899,24025,2937,940,6.3511492658,14756,5.8248369778,18588,3710,661,14.514707966,18296,3.306524802,5503,1308
2023-2024,12,16,Montérégie,CISSS DE LA MONTÉRÉGIE-EST,HÔPITAL PIERRE-BOUCHER,51229011,53299,11432,3180,13.358112697,38494,5.0410689905,25820,3578,956,6.7471569735,11303,6.7852412585,27479,7353,2645,19.569942704,27191,4.3160357389,7854,2224
2023-2024,12,16,Montérégie,CISSS DE LA MONTÉRÉGIE-EST,HÔTEL-DIEU DE SOREL,51229102,34522,5477,1709,8.1968249313,29508,2.4579430437,23797,2168,581,4.1380476297,18866,2.7593935887,10725,2910,566,17.202580031,10642,1.9235354152,3309,1128
2023-2024,12,16,Montérégie,CISSS DE LA MONTÉRÉGIE-OUEST,HÔPITAL ANNA-LABERGE,51229151,33998,7565,2134,18.63222804,26449,2.4632665171,20503,2154,477,10.552409674,12955,3.9564745487,13495,6571,2985,30.907923922,13494,1.0297027074,5411,1657
2023-2024,12,16,Montérégie,CISSS DE LA MONTÉRÉGIE-OUEST,HÔPITAL BARRIE MEMORIAL / BARRIE MEMORIAL HOSPITAL,51228005,19894,2153,360,6.4447887694,16717,3.2818568756,16877,1290,277,4.41542023,13721,3.1607929654,3017,761,172,17.797010459,2996,3.8363021065,863,83
2023-2024,12,16,Montérégie,CISSS DE LA MONTÉRÉGIE-OUEST,HÔPITAL DU SUROÎT,51229136,37066,7510,2867,13.244615835,29436,2.4841474442,23919,2305,1664,4.8443604457,16408,3.3167026078,13147,4952,2608,28.527624025,13028,1.4355931669,5205,1203
2024-2025,12,01,Bas-Saint-Laurent,CISSS DU BAS-SAINT-LAURENT,CENTRE HOSPITALIER RÉGIONAL DU GRAND-PORTAGE,51218352,20978,4208,1002,5.091600857,17417,2.2820990348,15253,1768,574,3.355952472,11733,2.5788635331,5725,178,0,9.7158532266,5684,1.6695132047,2440,428
2024-2025,12,01,Bas-Saint-Laurent,CISSS DU BAS-SAINT-LAURENT,CENTRE MULTISERVICES DE SANTÉ ET DE SERVICES SOCIAUX DE TROIS-PISTOLES,51236156,11622,1624,306,3.2553681954,10599,1.5773709522,10043,1051,229,2.624101945,9043,1.6746114244,1579,14,1,7.2704454296,1556,1.0122388246,573,77
2024-2025,12,01,Bas-Saint-Laurent,CISSS DU BAS-SAINT-LAURENT,CLSC DE POHÉNÉGAMOOK,51219418,12229,1421,416,1.824611897,11459,1.007740689,11591,1233,389,1.5419648865,10824,1.015952051,638,20,0,6.9596612679,635,0.8677725284,188,27
2024-2025,12,01,Bas-Saint-Laurent,CISSS DU BAS-SAINT-LAURENT,HÔPITAL D'AMQUI,51226892,14656,2343,456,4.9380243776,12728,1.8410170272,10367,1085,280,3.6189965757,8586,2.1913753332,4289,269,44,8.1262643455,4142,1.1147552176,1258,176
2024-2025,12,01,Bas-Saint-Laurent,CISSS DU BAS-SAINT-LAURENT,HÔPITAL DE MATANE,51218980,16718,2924,645,5.1625399603,15054,2.4517622854,12417,1417,365,4.1182740732,10858,2.7486483085,4301,289,26,8.1773387326,4196,1.6835095594,1507,280
2024-2025,12,01,Bas-Saint-Laurent,CISSS DU BAS-SAINT-LAURENT,HÔPITAL DE NOTRE-DAME-DU-LAC,51221877,13522,2341,371,3.7294891453,12142,1.6122375272,10641,1275,186,2.5709416408,9278,1.8186216797,2881,61,1,8.0085950094,2864,0.9436508768,1066,185
2024-2025,12,01,Bas-Saint-Laurent,CISSS DU BAS-SAINT-LAURENT,HÔPITAL NOTRE-DAME-DE-FATIMA,51221141,17104,3035,487,4.6430926164,15543,2.1761441914,13519,1610,257,3.4919107059,12004,2.370081894,3585,133,3,8.984188362,3539,1.5183232866,1425,230
2024-2025,12,01,Bas-Saint-Laurent,CISSS DU BAS-SAINT-LAURENT,HÔPITAL RÉGIONAL DE RIMOUSKI,51227882,29385,5518,1581,6.8083388445,23287,2.7176521712,20818,2364,901,4.6412232203,14790,3.2729452145,8567,1061,139,12.074477874,8497,1.7511011403,3154,680
2024-2025,12,02,Saguenay-Lac-Saint-Jean,CIUSSS DU SAGUENAY - LAC-SAINT-JEAN,HÔPITAL D'ALMA,51219400,35043,5469,1343,4.910881861,27962,2.9323464484,27288,3018,662,3.8899426895,20381,3.1976681032,7755,138,1,8.5033239129,7581,2.2190473259,2451,681
2024-2025,12,02,Saguenay-Lac-Saint-Jean,CIUSSS DU SAGUENAY - LAC-SAINT-JEAN,HÔPITAL DE CHICOUTIMI,51218394,50583,8428,3074,8.032853429,44082,2.8734274887,28343,2476,887,4.4421491981,22062,3.8423046415,22240,3120,215,12.608902441,22020,1.9027023413,5952,2187
2024-2025,12,02,Saguenay-Lac-Saint-Jean,CIUSSS DU SAGUENAY - LAC-SAINT-JEAN,HÔPITAL DE DOLBEAU-MISTASSINI,51219384,21357,3443,715,5.006035713,19101,2.3235381946,18026,2257,436,3.5933810268,15794,2.5052291834,3331,430,109,12.650741019,3307,1.4557947788,1186,279
2024-2025,12,02,Saguenay-Lac-Saint-Jean,CIUSSS DU SAGUENAY - LAC-SAINT-JEAN,HÔPITAL DE LA BAIE,51221364,18553,2531,567,5.5844540416,16545,2.7748793358,14063,1094,327,4.1912995884,12100,3.0666633379,4490,153,2,9.9479130784,4445,1.9805966754,1437,240
2024-2025,12,02,Saguenay-Lac-Saint-Jean,CIUSSS DU SAGUENAY - LAC-SAINT-JEAN,HÔPITAL ET CENTRE D'HÉBERGEMENT DE ROBERVAL,51228203,24552,3450,1363,5.780666816,21898,2.6347650978,17165,1457,475,3.906548597,14668,2.8817166053,7387,542,32,10.13551171,7230,2.1337575304,1993,888
2024-2025,12,02,Saguenay-Lac-Saint-Jean,CIUSSS DU SAGUENAY - LAC-SAINT-JEAN,HÔPITAL ET CENTRE DE RÉADAPTATION DE JONQUIÈRE,51224541,25767,4919,1352,7.4864382414,20328,3.7957377891,16149,1672,522,4.7434777179,11022,4.1636991673,9618,865,19,12.091976762,9306,3.3599253767,3247,830
2024-2025,12,03,Capitale-Nationale,CHU DE QUÉBEC - UNIVERSITÉ LAVAL,CENTRE HOSPITALIER DE L'UNIVERSITÉ LAVAL,51217594,72489,6839,6789,8.2099557059,58180,2.4727961117,41270,1358,2366,5.1261306976,27175,3.6081187264,31219,3608,627,12.286622418,31005,1.4777181548,5481,4423
2024-2025,12,03,Capitale-Nationale,CHU DE QUÉBEC - UNIVERSITÉ LAVAL,HÔPITAL DE L'ENFANT-JÉSUS,51233914,61359,10955,7413,9.9187899629,54837,1.8174790997,33965,3367,1966,4.2550002862,27668,2.3148139447,27394,6570,1095,16.941153122,27169,1.3110099439,7588,5447
2024-2025,12,03,Capitale-Nationale,CHU DE QUÉBEC - UNIVERSITÉ LAVAL,HÔPITAL DU SAINT-SACREMENT,51217529,34848,8115,1017,7.7465730936,28720,2.1362554163,24534,3219,366,3.9228604522,18443,2.5588289294,10314,2716,349,16.842071052,10277,1.3779092742,4896,651
2024-2025,12,03,Capitale-Nationale,CHU DE QUÉBEC - UNIVERSITÉ LAVAL,HÔPITAL SAINT-FRANÇOIS D'ASSISE,51217602,39143,10212,1278,11.108837077,32232,2.4548755895,22141,2699,615,5.149213124,15280,3.5223334788,17002,5358,599,18.869808372,16952,1.4927025982,7513,663
2024-2025,12,03,Capitale-Nationale,CHU DE QUÉBEC - UNIVERSITÉ LAVAL,L'HÔTEL-DIEU DE QUÉBEC,51217586,21979,4902,973,7.2872356694,19464,1.8960696671,11865,1104,421,3.5649933277,9479,2.2119367667,10114,875,15,11.653896277,9985,1.5962094531,3798,552
2024-2025,12,03,Capitale-Nationale,CIUSSS DE LA CAPITALE-NATIONALE,CENTRE MULTISERVICES DE SANTÉ ET DE SERVICES SOCIAUX CHAUVEAU,51225001,41362,2874,603,3.016911517,28952,1.8017719367,38099,2501,538,2.8945420192,25734,1.9060338031,3263,0,0,4.4457057241,3218,0.9680010013,373,65
2024-2025,12,03,Capitale-Nationale,CIUSSS DE LA CAPITALE-NATIONALE,CENTRE MULTISERVICES DE SANTÉ ET DE SERVICES SOCIAUX DE BAIE-SAINT-PAUL,51244804,13086,2255,402,5.6471867942,10165,2.5019512215,10516,1320,193,3.5962213664,7627,2.7921084087,2570,383,65,14.039386187,2538,1.6299934331,935,209
2024-2025,12,03,Capitale-Nationale,CIUSSS DE LA CAPITALE-NATIONALE,CENTRE MULTISERVICES DE SANTÉ ET DE SERVICES SOCIAUX DE SAINT-MARC-DES-CARRIÈRES,51247344,17950,2285,349,2.9549322965,14895,1.5467102682,15124,1335,231,2.3145295373,12107,1.7425868873,2826,71,9,6.3821974522,2788,0.6961083214,950,118
2024-2025,12,03,Capitale-Nationale,CIUSSS DE LA CAPITALE-NATIONALE,CENTRE MULTISERVICES DE SANTÉ ET DE SERVICES SOCIAUX DE SAINT-RAYMOND,51247302,19254,2804,386,4.6661371519,15190,2.2022896094,15178,1439,228,3.5764905528,11200,2.5571863591,4076,208,34,8.7237073383,3990,1.2060882066,1365,158
2024-2025,12,03,Capitale-Nationale,CIUSSS DE LA CAPITALE-NATIONALE,CENTRE MULTISERVICES DE SANTÉ ET DE SERVICES SOCIAUX DE SAINTE-ANNE-DE-BEAUPRÉ,51225357,15939,1881,243,4.3728967557,12220,2.2423589516,13332,1095,159,3.4701916025,9669,2.4843581434,2607,124,16,8.9892623492,2551,1.3251146609,786,84
2024-2025,12,03,Capitale-Nationale,CIUSSS DE LA CAPITALE-NATIONALE,HÔPITAL ET CLSC DE LA MALBAIE,51228690,14408,2505,396,5.0165953328,11982,1.8360420028,11909,1637,224,3.3129477706,9491,2.0933894684,2499,340,59,13.135338358,2491,0.8555181988,868,172
2024-2025,12,03,Capitale-Nationale,INSTITUT UNIVERSITAIRE DE CARDIOLOGIE ET DE PNEUMOLOGIE DE QUÉBEC - UNIVERSITÉ LAVAL,INSTITUT UNIVERSITAIRE DE CARDIOLOGIE ET DE PNEUMOLOGIE DE QUÉBEC,51232130,28743,9651,570,8.0727177052,26803,2.1119830595,15034,3375,303,4.0939871477,13141,2.6736753714,13709,1536,0,12.43599987,13662,1.5717108688,6276,267
2024-2025,12,04,Mauricie et Centre-du-Québec,CIUSSS DE LA MAURICIE-ET-DU-CENTRE-DU-QUÉBEC,CENTRE MULTISERVICES DE SANTÉ ET DE SERVICES SOCIAUX AVELLIN-DALCOURT,51233583,21676,3106,462,4.8290270473,17379,2.8728774671,18498,1792,244,4.0140231376,14233,3.1932786287,3178,173,26,9.5728729634,3146,1.4233320972,1314,218
2024-2025,12,04,Mauricie et Centre-du-Québec,CIUSSS DE LA MAURICIE-ET-DU-CENTRE-DU-QUÉBEC,CENTRE MULTISERVICES DE SANTÉ ET DE SERVICES SOCIAUX CHRIST-ROI,51246338,22097,2543,591,5.3794999195,17542,3.5068576686,17746,1162,332,4.416871799,13367,3.8361037339,4351,262,42,9.3056774943,4175,2.4527182302,1381,259
2024-2025,12,04,Mauricie et Centre-du-Québec,CIUSSS DE LA MAURICIE-ET-DU-CENTRE-DU-QUÉBEC,CENTRE MULTISERVICES DE SANTÉ ET DE SERVICES SOCIAUX DE FORTIERVILLE,51219160,11729,1237,181,2.7618514413,8739,2.1847985086,10796,1074,164,2.6612797693,7817,2.290024768,933,0,0,3.9255939621,922,1.2926578694,163,17
2024-2025,12,04,Mauricie et Centre-du-Québec,CIUSSS DE LA MAURICIE-ET-DU-CENTRE-DU-QUÉBEC,CENTRE MULTISERVICES DE SANTÉ ET DE SERVICES SOCIAUX DU HAUT-SAINT-MAURICE,51219731,11883,1725,634,6.1256886589,10252,2.8514539169,8828,972,307,4.2347489679,7250,3.0829842912,3055,250,7,11.589916348,3002,2.2922949515,753,327
2024-2025,12,04,Mauricie et Centre-du-Québec,CIUSSS DE LA MAURICIE-ET-DU-CENTRE-DU-QUÉBEC,HÔPITAL DU CENTRE-DE-LA-MAURICIE,51220051,33245,6556,2279,7.7704334403,27054,2.952875422,20355,1939,513,4.9486055842,14233,4.2600003318,12890,1509,140,12.226469593,12821,1.5017944735,4617,1766
2024-2025,12,04,Mauricie et Centre-du-Québec,CIUSSS DE LA MAURICIE-ET-DU-CENTRE-DU-QUÉBEC,HÔPITAL SAINTE-CROIX,51228781,40771,6465,2398,8.4210158228,29981,3.8168814786,22768,1741,630,6.2199030559,12609,5.3343560816,18003,1638,15,11.204714955,17372,2.7154632614,4724,1768
2024-2025,12,04,Mauricie et Centre-du-Québec,CIUSSS DE LA MAURICIE-ET-DU-CENTRE-DU-QUÉBEC,HÔTEL-DIEU D'ARTHABASKA,51228039,36588,7043,1982,6.247234863,30441,2.4868257449,21214,2303,402,4.457459631,15353,3.2915384796,15374,684,6,8.7168778818,15088,1.667979336,4740,1580
2024-2025,12,04,Mauricie et Centre-du-Québec,CIUSSS DE LA MAURICIE-ET-DU-CENTRE-DU-QUÉBEC,PAVILLON SAINTE-MARIE,51220168,57703,13559,3295,10.169250419,43995,3.5306862838,31764,3310,992,5.6102416782,18301,5.1100441536,25939,5625,454,15.752054446,25694,2.4057610726,10249,2303
2024-2025,12,05,Estrie,CIUSSS DE L'ESTRIE - CENTRE HOSPITALIER UNIVERSITAIRE DE SHERBROOKE,CENTRE DE SANTÉ ET DE SERVICES SOCIAUX DU GRANIT,51223832,15095,2461,393,5.2499984358,12947,3.1217265046,12154,1455,211,4.309941743,10034,3.3886771089,2941,110,2,9.1348842042,2913,2.2021994317,1006,182
2024-2025,12,05,Estrie,CIUSSS DE L'ESTRIE - CENTRE HOSPITALIER UNIVERSITAIRE DE SHERBROOKE,CENTRE MULTISERVICES DE SANTÉ ET DE SERVICES SOCIAUX DE LA MRC DE COATICOOK,51247617,21079,1586,590,2.9935839909,16863,2.294628526,16794,1012,455,2.8208487158,12695,2.4520269354,4285,0,0,3.6705772721,4168,1.8152204628,574,135
2024-2025,12,05,Estrie,CIUSSS DE L'ESTRIE - CENTRE HOSPITALIER UNIVERSITAIRE DE SHERBROOKE,CENTRE MULTISERVICES DE SANTÉ ET DE SERVICES SOCIAUX DE MEMPHRÉMAGOG,51219046,23086,4732,761,7.5094381997,18037,4.1581943443,16745,2154,349,5.4457142265,11865,4.799374561,6341,966,176,12.959218665,6172,2.9255949809,2578,412
2024-2025,12,05,Estrie,CIUSSS DE L'ESTRIE - CENTRE HOSPITALIER UNIVERSITAIRE DE SHERBROOKE,CENTRE MULTISERVICES DE SANTÉ ET DE SERVICES SOCIAUX DES SOURCES,51247583,17761,2216,579,5.1973471057,14903,3.5973091734,15384,1464,391,4.6431349129,12567,3.875681348,2377,96,5,8.7842214743,2336,2.0997479072,752,188
2024-2025,12,05,Estrie,CIUSSS DE L'ESTRIE - CENTRE HOSPITALIER UNIVERSITAIRE DE SHERBROOKE,CHUS - HÔPITAL FLEURIMONT,51216687,41194,5990,970,8.9196149116,34465,3.0708917259,21700,1194,320,6.6415099846,14976,5.3817029469,19494,2118,60,11.455517082,19489,1.2951870286,4796,650
2024-2025,12,05,Estrie,CIUSSS DE L'ESTRIE - CENTRE HOSPITALIER UNIVERSITAIRE DE SHERBROOKE,CHUS - HÔTEL-DIEU DE SHERBROOKE,51216695,41213,9003,4745,11.57745412,34298,3.5405208273,20674,2323,1148,7.0224033408,13802,5.5993177317,20539,3683,866,16.162444618,20496,2.1541276347,6680,3597
2024-2025,12,05,Estrie,CIUSSS DE L'ESTRIE - CENTRE HOSPITALIER UNIVERSITAIRE DE SHERBROOKE,HÔPITAL BROME-MISSISQUOI-PERKINS,51229185,28209,4613,951,9.3096378815,23157,4.1413758379,19304,1399,350,5.8219335659,14349,4.7905844194,8905,2333,212,16.870181858,8808,3.0837584519,3214,601
2024-2025,12,05,Estrie,CIUSSS DE L'ESTRIE - CENTRE HOSPITALIER UNIVERSITAIRE DE SHERBROOKE,HÔPITAL DE GRANBY,51228120,36311,6110,2141,11.906887605,27197,5.1181642583,25172,2348,844,7.9563906324,16109,6.6243736421,11139,4168,586,20.834251803,11088,2.9298952321,3762,1297
2024-2025,12,06,Montréal,CENTRE HOSPITALIER DE L'UNIVERSITÉ DE MONTRÉAL,CENTRE HOSPITALIER DE L'UNIVERSITÉ DE MONTRÉAL,51236297,74220,11085,6364,12.177589681,53258,3.1781442851,44790,3093,2358,7.5549628947,24035,5.1944603472,29430,9124,1050,19.212841252,29223,1.5197876292,7992,4006
2024-2025,12,06,Montréal,CENTRE HOSPITALIER UNIVERSITAIRE SAINTE-JUSTINE,CHU SAINTE-JUSTINE,51222800,77508,1,1847,5.1373579645,65445,1.8524657006,50160,0,696,4.3370859417,38804,2.3953077647,27348,469,9,6.6051671156,26641,1.0617880439,1,1151
2024-2025,12,06,Montréal,CENTRE UNIVERSITAIRE DE SANTÉ MCGILL,HÔPITAL DE LACHINE,51228310,18576,2957,575,11.283140881,15440,3.3151000288,14184,1330,258,5.25031344,11089,3.5675219938,4392,1626,881,30.76620655,4351,2.671775007,1627,317
2024-2025,12,06,Montréal,CENTRE UNIVERSITAIRE DE SANTÉ MCGILL,HÔPITAL GÉNÉRAL DE MONTRÉAL,51248219,32732,4664,4350,16.621790127,28244,1.6428609715,15717,1170,920,5.762093699,11352,2.3930816645,17015,5360,2769,26.653047768,16892,1.138687084,3494,3430
2024-2025,12,06,Montréal,CENTRE UNIVERSITAIRE DE SANTÉ MCGILL,HÔPITAL ROYAL VICTORIA,51223295,45184,7428,1124,17.438349655,34492,4.3688379028,26970,1809,476,8.9765821901,16608,6.199437587,18214,7757,3706,29.967935059,17884,2.6688491109,5619,648
2024-2025,12,06,Montréal,CENTRE UNIVERSITAIRE DE SANTÉ MCGILL,L'HÔPITAL DE MONTRÉAL POUR ENFANTS,51223279,72144,9,2188,5.6740306424,65913,1.723112474,56851,2,623,4.7559985508,50655,1.9793890863,15293,645,26,9.0867712715,15258,0.8723003233,7,1565
2024-2025,12,06,Montréal,CIUSSS DE L'EST-DE-L'ÎLE-DE-MONTRÉAL,HÔPITAL MAISONNEUVE-ROSEMONT,12934659,66318,11543,3931,12.315004055,45980,3.6881808455,40202,3055,891,5.4010596142,20117,5.2430500737,26116,9354,2995,22.958073222,25863,2.4787579532,8488,3040
2024-2025,12,06,Montréal,CIUSSS DE L'EST-DE-L'ÎLE-DE-MONTRÉAL,HÔPITAL SANTA CABRINI,51235919,34869,8960,1245,14.475216525,26491,3.3037871877,19713,2094,446,5.6560357801,11412,4.9133470616,15156,5844,2363,25.946086808,15079,2.0856495605,6866,799
2024-2025,12,06,Montréal,CIUSSS DE L'EST-DE-L'ÎLE-DE-MONTRÉAL,INSTITUT UNIVERSITAIRE EN SANTÉ MENTALE DE MONTRÉAL,51235307,4619,189,4606,13.793541471,4506,1.340532993,2257,75,2248,3.2915479004,2144,1.3848621476,2362,835,254,23.828680967,2362,1.300295183,114,2358
2024-2025,12,06,Montréal,CIUSSS DE L'OUEST-DE-L'ÎLE-DE-MONTRÉAL,CENTRE HOSPITALIER DE ST. MARY,51248243,33177,6828,2338,10.932590491,29358,2.8212923129,20705,2023,757,6.2103343529,16917,3.6022021405,12472,3360,475,18.772096051,12441,1.7594281899,4805,1581
2024-2025,12,06,Montréal,CIUSSS DE L'OUEST-DE-L'ÎLE-DE-MONTRÉAL,HÔPITAL DE LASALLE,51224392,27085,4243,761,10.069895494,21667,3.6045301226,20693,1661,268,5.8550504867,15307,4.2825082751,6392,2299,903,23.71473087,6360,1.9727987421,2582,493
2024-2025,12,06,Montréal,CIUSSS DE L'OUEST-DE-L'ÎLE-DE-MONTRÉAL,HÔPITAL DOUGLAS,51235190,5787,129,5617,13.37038261,5360,2.232666874,2921,53,2771,4.0942918141,2500,2.3566755556,2866,1104,148,22.824486315,2860,2.1242676768,76,2846
2024-2025,12,06,Montréal,CIUSSS DE L'OUEST-DE-L'ÎLE-DE-MONTRÉAL,HÔPITAL GÉNÉRAL DU LAKESHORE,51228278,36683,8964,2210,15.549044214,29562,3.1785978057,21855,2325,292,7.6321920994,14803,4.2934096504,14828,5832,2398,27.217698311,14759,2.0604624485,6639,1918
2024-2025,12,06,Montréal,CIUSSS DU CENTRE-OUEST-DE-L'ÎLE-DE-MONTRÉAL,HÔPITAL GÉNÉRAL JUIF,51248250,89703,17089,4602,11.179665916,77395,2.5192856594,31675,1993,453,3.7704825485,20737,2.8908876378,58028,9905,3391,15.224021799,56658,2.3832782073,15096,4149
2024-2025,12,06,Montréal,CIUSSS DU CENTRE-SUD-DE-L'ÎLE-DE-MONTRÉAL,HÔPITAL DE VERDUN,51218097,41374,7526,2339,10.128118572,34674,2.3909608064,27454,2382,874,4.8735933541,20792,3.1301226968,13920,4790,985,20.491461626,13882,1.2838685988,5144,1465
2024-2025,12,06,Montréal,CIUSSS DU CENTRE-SUD-DE-L'ÎLE-DE-MONTRÉAL,HÔPITAL NOTRE-DAME,51236313,36697,5363,5367,11.84502476,30907,2.2367113437,22315,1117,2161,5.8709234571,16569,3.1379320317,14382,4295,808,21.11439415,14338,1.1952602641,4246,3206
2024-2025,12,06,Montréal,CIUSSS DU NORD-DE-L'ÎLE-DE-MONTRÉAL,HÔPITAL DU SACRÉ-COEUR-DE-MONTRÉAL,12475976,63721,12018,2825,12.265567762,47883,3.5527523338,42887,3659,1110,6.7464418252,27106,5.0242567041,20834,8468,2575,23.626744398,20777,1.6330046579,8359,1715
2024-2025,12,06,Montréal,CIUSSS DU NORD-DE-L'ÎLE-DE-MONTRÉAL,HÔPITAL EN SANTÉ MENTALE ALBERT-PRÉVOST,51848752,3147,115,3137,24.514007785,3111,0.4395876638,1347,56,1337,4.6066155242,1311,0.6261818798,1800,1227,598,39.411372994,1800,0.3036848765,59,1800
2024-2025,12,06,Montréal,CIUSSS DU NORD-DE-L'ÎLE-DE-MONTRÉAL,HÔPITAL FLEURY,51228492,29704,5041,764,9.8245179755,22256,3.543451953,21418,1783,350,5.6247830226,14001,4.4498437612,8286,2815,464,20.680168859,8255,2.0061543509,3258,414
2024-2025,12,06,Montréal,CIUSSS DU NORD-DE-L'ÎLE-DE-MONTRÉAL,HÔPITAL JEAN-TALON,51228500,40218,5301,3192,8.2309956225,28988,3.3145707802,29888,1664,1159,5.0939941058,18708,4.2770570522,10330,2749,238,17.307346187,10280,1.5629955685,3637,2033
2024-2025,12,06,Montréal,INSTITUT DE CARDIOLOGIE DE MONTRÉAL,INSTITUT DE CARDIOLOGIE DE MONTRÉAL,51248201,19632,5309,469,7.4764669219,18959,1.6445314744,13070,2603,417,3.6129592153,12400,1.8945264113,6562,1193,74,15.171688764,6559,1.1719080229,2706,52
2024-2025,12,07,Outaouais,CISSS DE L'OUTAOUAIS,CENTRE MULTISERVICES DE SANTÉ ET DE SERVICES SOCIAUX DE MANSFIELD-ET-PONTEFRACT,51245058,9285,1011,219,3.7655112487,8704,1.7553311696,9029,951,207,3.6056636948,8448,1.7574189157,256,12,0,9.4032595486,256,1.6864355469,60,12
2024-2025,12,07,Outaouais,CISSS DE L'OUTAOUAIS,CLSC ET CENTRE D'HÉBERGEMENT DE LA PETITE-NATION,51219491,11059,1401,341,3.5805270468,9327,1.9934714628,10134,1102,322,3.4654613732,8408,2.117314958,925,2,0,4.8411492492,919,0.8604180268,299,19
2024-2025,12,07,Outaouais,CISSS DE L'OUTAOUAIS,HÔPITAL DE GATINEAU,51221703,37841,5280,4437,13.663737598,23856,6.3726830543,23234,1696,1065,7.5389059974,10025,7.249904655,14607,4568,1549,23.405939105,13831,5.736854369,3584,3372
2024-2025,12,07,Outaouais,CISSS DE L'OUTAOUAIS,HÔPITAL DE HULL,51221711,33602,6751,1021,14.030895846,22719,5.8602863242,20774,1876,581,7.9890734679,10304,6.969209692,12828,4688,1728,23.815181634,12415,4.9399201235,4875,440
2024-2025,12,07,Outaouais,CISSS DE L'OUTAOUAIS,HÔPITAL DE MANIWAKI,51221893,13386,1865,772,7.2938540681,11393,2.5979751456,9897,965,389,3.768656804,7989,2.7235684483,3489,760,321,17.293532292,3404,2.3032146005,900,383
2024-2025,12,07,Outaouais,CISSS DE L'OUTAOUAIS,HÔPITAL ET CHSLD DE PAPINEAU,51228823,23585,2988,970,8.7638694203,17098,4.4088661279,17286,1244,376,4.6707969841,10918,4.7192534245,6299,1866,491,19.996263472,6180,3.8605152373,1744,594
2024-2025,12,07,Outaouais,CISSS DE L'OUTAOUAIS,HÔPITAL ET CHSLD DU PONTIAC,51219459,12123,1438,369,5.9167879238,10918,2.4815377511,10958,1152,257,4.7775651477,9756,2.5424167464,1165,231,67,16.632327134,1162,1.9704056703,286,112
2024-2025,12,07,Outaouais,CISSS DE L'OUTAOUAIS,HÔPITAL ET CHSLD MÉMORIAL DE WAKEFIELD / WAKEFIELD MEMORIAL HOSPITAL,51228799,16670,1337,372,5.7214896854,13471,3.3970208225,14715,879,265,4.6101112055,11545,3.5422469804,1955,318,45,14.086673487,1926,2.5264933079,458,107
2024-2025,12,08,Abitibi-Témiscamingue,CISSS DE L'ABITIBI-TÉMISCAMINGUE,CENTRE MULTISERVICES DE SANTÉ ET DE SERVICES SOCIAUX DE LA SARRE,51247559,18160,2328,896,6.1757888522,15919,2.9295554927,14631,1333,664,4.9993862157,12451,3.0960884222,3529,407,52,11.053076178,3468,2.3316600186,995,232
2024-2025,12,08,Abitibi-Témiscamingue,CISSS DE L'ABITIBI-TÉMISCAMINGUE,CENTRE MULTISERVICES DE SANTÉ ET DE SERVICES SOCIAUX DE TÉMISCAMING-KIPAWA,51247476,5155,513,328,2.4805957,4870,0.9214531713,4833,424,299,1.9317740879,4549,0.9417277301,322,20,0,10.718033126,321,0.634135514,89,29
2024-2025,12,08,Abitibi-Témiscamingue,CISSS DE L'ABITIBI-TÉMISCAMINGUE,CENTRE MULTISERVICES DE SANTÉ ET DE SERVICES SOCIAUX DE VILLE-MARIE,51247542,11673,1619,536,5.0349269444,9993,2.8512317511,9843,1072,364,4.0751586858,8192,2.9550968085,1830,92,9,10.197221463,1801,2.3787928003,547,172
2024-2025,12,08,Abitibi-Témiscamingue,CISSS DE L'ABITIBI-TÉMISCAMINGUE,HÔPITAL D'AMOS,51228906,24464,2624,970,5.0202847835,21849,2.1679741254,18610,1125,756,3.5867280733,16055,2.4315948995,5854,459,28,9.5775943799,5794,1.4374888774,1499,214
2024-2025,12,08,Abitibi-Témiscamingue,CISSS DE L'ABITIBI-TÉMISCAMINGUE,HÔPITAL DE ROUYN-NORANDA,51228922,26141,3505,1453,7.4267426329,19975,4.2256188708,21087,1806,995,6.4712263348,14992,4.8125215671,5054,453,12,11.413480302,4983,2.4598461993,1699,458
2024-2025,12,08,Abitibi-Témiscamingue,CISSS DE L'ABITIBI-TÉMISCAMINGUE,HÔPITAL DE VAL-D'OR,51225589,26618,3043,1611,8.3412503131,21335,4.3144359295,21981,1760,1165,6.3194759237,16715,4.890912753,4637,1284,299,17.925167254,4620,2.2287627465,1283,446
2024-2025,12,09,Côte-Nord,CISSS DE LA CÔTE-NORD,CENTRE MULTISERVICES DE SANTÉ ET DE SERVICES SOCIAUX DE FERMONT,51245108,6065,38,373,6.4145713108,5300,2.9020957023,5681,32,336,6.3275250836,4919,2.9946509566,384,5,1,7.7023567708,381,1.7071369204,6,37
2024-2025,12,09,Côte-Nord,CISSS DE LA CÔTE-NORD,CENTRE MULTISERVICES DE SANTÉ ET DE SERVICES SOCIAUX DE FORESTVILLE,51218741,10054,1471,535,4.0524772064,8217,2.253854847,8686,1056,424,3.3583507944,6995,2.4283639902,1368,85,16,8.459774001,1222,1.2549256683,415,111
2024-2025,12,09,Côte-Nord,CISSS DE LA CÔTE-NORD,CENTRE MULTISERVICES DE SANTÉ ET DE SERVICES SOCIAUX DE LA BASSE-CÔTE-NORD,51245140,3613,555,128,2.7300713473,3520,0.8860099432,3058,406,114,2.470589165,2965,0.9037334645,555,1,0,4.1597947948,555,0.7913248248,149,14
2024-2025,12,09,Côte-Nord,CISSS DE LA CÔTE-NORD,CENTRE MULTISERVICES DE SANTÉ ET DE SERVICES SOCIAUX DE LA MINGANIE,51245116,10712,1104,399,4.1322558813,6773,2.6860347458,6907,709,150,2.3054293551,3067,2.7866580625,3805,199,13,7.4483901299,3706,2.602761213,395,249
2024-2025,12,09,Côte-Nord,CISSS DE LA CÔTE-NORD,CENTRE MULTISERVICES DE SANTÉ ET DE SERVICES SOCIAUX DE PORT-CARTIER,51245132,13849,1177,544,6.1117444902,11585,3.3237064931,12683,907,472,4.9835597519,10433,3.4858519708,1166,255,101,18.383414332,1152,1.8552483603,270,72
2024-2025,12,09,Côte-Nord,CISSS DE LA CÔTE-NORD,CENTRE MULTISERVICES DE SANTÉ ET DE SERVICES SOCIAUX DES ESCOUMINS,51218733,9517,1403,395,4.2516703151,8313,1.8979832124,8320,947,331,3.4496935764,7142,1.9556107844,1197,74,8,9.8259781398,1171,1.5465091565,456,64
2024-2025,12,09,Côte-Nord,CISSS DE LA CÔTE-NORD,CLSC ET HÔPITAL LE ROYER,51228765,21321,3125,1310,9.3634211706,18397,3.8518362293,15693,1313,660,6.0333527688,12779,4.51772287,5628,1480,563,18.648915739,5618,2.3371752502,1812,650
2024-2025,12,09,Côte-Nord,CISSS DE LA CÔTE-NORD,HÔPITAL ET CLSC DE SEPT-ÎLES,51232023,20904,2454,1581,9.3134972972,15704,4.6703424287,14703,1025,657,6.0760051237,9670,5.2326057394,6201,1281,365,16.989815218,6034,3.7692674843,1429,924
2024-2025,12,11,Gaspésie-Îles-de-la-Madeleine,CISSS DE LA GASPÉSIE,CENTRE MULTISERVICES DE SANTÉ ET DE SERVICES SOCIAUX DE GRANDE-VALLÉE,51247732,6382,1235,155,2.3200315993,4930,1.1669185824,6010,1084,149,1.9784816047,4583,1.1953094164,372,28,4,7.8380839307,347,0.791946846,151,6
2024-2025,12,11,Gaspésie-Îles-de-la-Madeleine,CISSS DE LA GASPÉSIE,CLSC ET CENTRE DE SERVICES AMBULATOIRES DE MURDOCHVILLE,51221307,2001,260,85,3.2766130823,1916,1.6754652343,1949,238,85,3.2000105467,1866,1.6904440574,52,1,0,6.1477350427,50,1.1164555556,22,0
2024-2025,12,11,Gaspésie-Îles-de-la-Madeleine,CISSS DE LA GASPÉSIE,CLSC ET CENTRE DE SERVICES AMBULATOIRES DE PASPÉBIAC,51220978,13219,2348,479,4.1298672996,12280,1.9744858397,9568,1412,363,3.2830283816,8751,2.0971116634,3651,125,15,6.3491372988,3529,1.6704057649,936,116
2024-2025,12,11,Gaspésie-Îles-de-la-Madeleine,CISSS DE LA GASPÉSIE,HÔPITAL DE CHANDLER,51227775,16359,2708,597,5.0244406579,14145,2.3159795962,14207,1786,468,4.0131022657,12007,2.470582785,2152,171,4,11.701059867,2138,1.4477286665,922,129
2024-2025,12,11,Gaspésie-Îles-de-la-Madeleine,CISSS DE LA GASPÉSIE,HÔPITAL DE GASPÉ,51220903,13929,2130,552,5.3892221265,12019,1.7146622708,11027,1259,316,3.6671843354,9174,1.9645782768,2902,338,34,11.932609694,2845,0.9087819762,871,236
2024-2025,12,11,Gaspésie-Îles-de-la-Madeleine,CISSS DE LA GASPÉSIE,HÔPITAL ET CLSC DE SAINTE-ANNE-DES-MONTS,51247799,13577,2273,589,5.6895367779,12149,2.31767011,10676,1317,373,3.5302033897,9278,2.5079679529,2901,480,109,13.636121835,2871,1.7026985371,956,216
2024-2025,12,11,Gaspésie-Îles-de-la-Madeleine,CISSS DE LA GASPÉSIE,HÔPITAL ET GROUPE DE MÉDECINE DE FAMILLE UNIVERSITAIRE DE MARIA,51227908,16550,2938,826,6.5762413729,15077,2.2712532702,12302,1443,402,4.0310664933,10847,2.5417055919,4248,790,113,13.946943202,4230,1.5777316785,1495,424
2024-2025,12,11,Gaspésie-Îles-de-la-Madeleine,CISSS DES ÎLES,HÔPITAL DE L'ARCHIPEL,51227783,14888,2259,446,4.8589109238,12765,1.8608061322,11918,1437,222,3.3390284071,9838,1.979989553,2970,312,63,10.957887299,2927,1.4602162814,822,224
2024-2025,12,12,Chaudière-Appalaches,CISSS DE CHAUDIÈRE-APPALACHES,CHSLD ET HÔPITAL PAUL-GILBERT,51245199,40434,3284,436,2.7827078971,31969,2.0336599345,40344,3260,435,2.7829680098,31879,2.0385755426,90,0,0,2.6661080247,90,0.2924969136,24,1
2024-2025,12,12,Chaudière-Appalaches,CISSS DE CHAUDIÈRE-APPALACHES,HÔPITAL DE MONTMAGNY,51245223,34681,5324,1061,4.5585797619,31969,1.6534270787,27612,2875,609,2.7643517915,24907,1.9207150266,7069,831,70,11.566957569,7062,0.7107279965,2449,452
2024-2025,12,12,Chaudière-Appalaches,CISSS DE CHAUDIÈRE-APPALACHES,HÔPITAL DE SAINT-GEORGES,51228971,43215,7782,2084,6.8272165336,35964,2.5988775813,30418,3177,994,4.3994455951,23217,3.3238099597,12797,1740,141,12.597939079,12747,1.2785076881,4605,1090
2024-2025,12,12,Chaudière-Appalaches,CISSS DE CHAUDIÈRE-APPALACHES,HÔPITAL DE THETFORD,51245231,37926,6314,1203,6.3003977995,34598,2.0788378342,30121,3375,642,4.2319570233,26800,2.369966677,7805,1444,171,14.282909602,7798,1.0782924397,2939,561
2024-2025,12,12,Chaudière-Appalaches,CISSS DE CHAUDIÈRE-APPALACHES,HÔTEL-DIEU DE LÉVIS,51227569,73448,14636,4957,9.1768368135,65094,1.7614967116,50007,5632,2323,3.9390217703,41666,2.2794078572,23441,6538,2474,20.350737964,23428,0.8404071695,9004,2634
2024-2025,12,13,Laval,CISSS DE LAVAL,HÔPITAL DE LA CITÉ-DE-LA-SANTÉ,51228757,85984,16703,5655,11.002881253,66532,3.7259846139,53649,4988,1232,6.4194124722,34342,4.7515791726,32335,8992,1086,18.607598019,32190,2.6318259207,11715,4423
2024-2025,12,14,Lanaudière,CISSS DE LANAUDIÈRE,HÔPITAL DE LANAUDIÈRE ET CENTRE D'HÉBERGEMENT PARPHILIA-FERLAND,51244945,70739,12756,4749,9.5195386366,55467,2.8076162353,45328,3693,3242,5.5867613163,30207,3.7959450992,25411,6391,907,16.534804875,25260,1.625729854,9063,1507
2024-2025,12,14,Lanaudière,CISSS DE LANAUDIÈRE,HÔPITAL PIERRE-LE GARDEUR,51228062,76549,14421,4346,10.671026909,53297,4.0590034409,51735,4905,1446,5.8403083395,28555,4.797643388,24814,8924,1227,20.742648785,24742,3.2065313816,9516,2900
2024-2025,12,15,Laurentides,CISSS DES LAURENTIDES,CENTRE MULTISERVICES DE SANTÉ ET DE SERVICES SOCIAUX D'ARGENTEUIL,51245306,20155,2817,641,8.0481217647,15588,3.672520493,16534,1574,436,5.5726702552,11978,4.2304536094,3621,986,258,19.351384746,3610,1.8212953216,1243,205
2024-2025,12,15,Laurentides,CISSS DES LAURENTIDES,CENTRE MULTISERVICES DE SANTÉ ET DE SERVICES SOCIAUX DE RIVIÈRE-ROUGE,51217628,13227,1587,624,6.8840844065,11418,3.2550455178,10053,816,306,4.5919344143,8311,3.4547702175,3174,571,122,14.144003711,3107,2.7207964095,771,318
2024-2025,12,15,Laurentides,CISSS DES LAURENTIDES,CENTRE MULTISERVICES DE SANTÉ ET DE SERVICES SOCIAUX DE SAINTE-AGATHE,51246874,30984,5759,1768,11.217898369,23915,4.371368841,20391,2223,576,6.741641533,13421,5.5522260305,10593,3319,532,19.834470929,10494,2.8611454429,3536,1192
2024-2025,12,15,Laurentides,CISSS DES LAURENTIDES,HÔPITAL DE MONT-LAURIER,51217610,17856,2718,792,9.1701248102,14827,3.3286885599,13282,1373,394,6.0326580878,10313,3.6086331706,4574,1156,298,18.280713574,4514,2.6891075297,1345,398
2024-2025,12,15,Laurentides,CISSS DES LAURENTIDES,HÔPITAL DE SAINT-EUSTACHE,51228864,50614,10796,2894,12.93858608,36678,3.7526214473,29838,2917,630,6.9317177388,16028,5.3794232836,20776,7289,2009,21.565508372,20650,2.4899396153,7879,2264
2024-2025,12,15,Laurentides,CISSS DES LAURENTIDES,HÔPITAL DE SAINT-JÉRÔME,51228880,59635,10971,5476,14.880479752,44402,4.1459575395,34600,3376,1582,6.5166714435,19517,5.4939792232,25035,9131,4324,26.439807392,24885,3.0887206818,7595,3894
2024-2025,12,16,Montérégie,CISSS DE LA MONTÉRÉGIE-CENTRE,HÔPITAL CHARLES-LE MOYNE,51233799,71723,13643,5772,10.953267714,42560,5.2794487847,48731,5143,2093,6.2892812412,19588,6.0930402826,22992,8545,952,20.838476692,22972,4.585707262,8500,3679
2024-2025,12,16,Montérégie,CISSS DE LA MONTÉRÉGIE-CENTRE,HÔPITAL DU HAUT-RICHELIEU,51229045,56151,10283,3525,12.266919596,40282,4.6865874336,38320,3748,1070,6.8184133249,22542,5.9790980047,17831,6355,2885,23.976120443,17740,3.044210134,6535,2455
2024-2025,12,16,Montérégie,CISSS DE LA MONTÉRÉGIE-EST,HÔPITAL HONORÉ-MERCIER,51229193,44455,9139,2549,10.450499725,32250,5.0734126615,24539,3268,984,6.1938623778,12572,6.5380536996,19916,4247,917,15.695208696,19678,4.1376739111,5871,1565
2024-2025,12,16,Montérégie,CISSS DE LA MONTÉRÉGIE-EST,HÔPITAL PIERRE-BOUCHER,51229011,54949,12185,3360,12.9566221,40380,5.178709207,25717,3654,1026,6.828178129,11452,6.8895685373,29232,7257,2309,18.348151712,28928,4.5014151994,8531,2334
2024-2025,12,16,Montérégie,CISSS DE LA MONTÉRÉGIE-EST,HÔTEL-DIEU DE SOREL,51229102,34869,6161,1689,8.6560562391,27964,3.1022833921,23309,2450,535,4.60997439,16521,3.5915523341,11560,2967,559,16.814371275,11443,2.395894142,3711,1154
2024-2025,12,16,Montérégie,CISSS DE LA MONTÉRÉGIE-OUEST,HÔPITAL ANNA-LABERGE,51229151,34181,7455,2227,16.279621858,27933,1.9186887771,19748,1897,475,8.3284580998,13503,3.4122539847,14433,6159,2540,27.158827975,14430,0.5210719373,5558,1752
2024-2025,12,16,Montérégie,CISSS DE LA MONTÉRÉGIE-OUEST,HÔPITAL BARRIE MEMORIAL / BARRIE MEMORIAL HOSPITAL,51228005,20244,2254,378,6.6231482168,16984,3.2115248993,17244,1355,300,4.6408168542,13993,3.3362146351,3000,794,174,18.017588889,2991,2.6281803745,899,78
2024-2025,12,16,Montérégie,CISSS DE LA MONTÉRÉGIE-OUEST,HÔPITAL DU SUROÎT,51229136,38439,6982,3112,12.325136623,29910,2.3451349976,22345,1720,1618,4.4268792298,14401,3.1481625312,16094,4758,2529,23.291121553,15509,1.5994776689,5262,1494
